customer_id,recency,frequency,monetary,R,F,M,RFM_score
12346,325,1,77183.6,1,1,5,7
12347,2,7,4310.0,5,5,5,15
12348,75,4,1797.24,2,4,4,10
12349,18,1,1757.55,4,1,4,9
12350,310,1,334.4,1,1,2,4
12352,36,8,2506.04,3,5,5,13
12353,204,1,89.0,1,1,1,3
12354,232,1,1079.4,1,1,4,6
12355,214,1,459.4,1,1,2,4
12356,22,3,2811.43,4,3,5,12
12357,33,1,6207.67,3,1,5,9
12358,1,2,1168.06,5,2,4,11
12359,57,4,6372.58,3,4,5,12
12360,52,3,2662.06,3,3,5,11
12361,287,1,189.9,1,1,1,3
12362,3,10,5226.23,5,5,5,15
12363,109,2,552.0,2,2,3,7
12364,7,4,1313.1,5,4,4,13
12365,291,2,641.38,1,2,3,6
12367,4,1,168.9,5,1,1,7
12370,51,4,3545.69,3,4,5,12
12371,44,2,1887.96,3,2,4,9
12372,71,3,1298.04,3,3,4,10
12373,311,1,364.6,1,1,2,4
12374,25,1,742.9300000000001,4,1,3,8
12375,10,2,457.5,5,2,2,9
12377,315,2,1628.12,1,2,4,7
12378,129,1,4008.62,2,1,5,8
12379,81,2,852.24,2,2,3,7
12380,21,4,2724.81,4,4,5,13
12381,4,5,1845.31,5,4,4,13
12383,184,5,1850.56,1,4,4,9
12384,28,2,585.27,4,2,3,9
12386,337,2,401.9,1,2,2,5
12388,15,6,2780.66,4,4,5,13
12390,79,1,549.84,2,1,3,6
12391,21,1,460.89,4,1,2,7
12393,72,4,1582.6000000000001,2,4,4,10
12394,63,2,1272.48,3,2,4,9
12395,19,12,3018.63,4,5,5,14
12397,35,2,2409.9,3,2,5,10
12398,45,1,1635.6599999999999,3,1,4,8
12399,119,4,1108.65,2,4,4,10
12401,303,1,84.3,1,1,1,3
12402,323,1,225.6,1,1,1,3
12403,49,1,427.7,3,1,2,6
12405,148,1,1710.39,2,1,4,7
12406,22,2,3415.3,4,2,5,11
12407,49,5,1708.1200000000001,3,4,4,11
12408,32,5,2888.55,4,4,5,13
12409,78,3,11072.67,2,3,5,10
12410,308,2,693.3299999999999,1,2,3,6
12412,74,3,1226.88,2,3,4,9
12413,66,3,758.1,3,3,3,9
12414,217,3,562.41,1,3,3,7
12415,24,21,124914.53,4,5,5,14
12417,3,9,3649.1,5,5,5,15
12418,112,1,668.58,2,1,3,6
12420,63,1,600.39,3,1,3,7
12421,15,4,807.04,4,4,3,11
12422,95,3,803.5600000000001,2,3,3,8
12423,0,8,1859.31,5,5,4,14
12424,162,2,1760.96,2,2,4,8
12425,78,1,777.2,2,1,3,6
12426,194,1,582.73,1,1,3,5
12427,21,3,825.8,4,3,3,10
12428,25,9,7956.46,4,5,5,14
12429,9,4,3750.4,5,4,5,14
12430,43,1,256.4,3,1,2,6
12431,35,15,6487.45,3,5,5,13
12432,42,5,5059.32,3,4,5,12
12433,0,7,13375.87,5,5,5,15
12434,84,2,806.14,2,2,3,7
12435,79,2,7829.89,2,2,5,9
12436,99,1,509.01,2,1,3,6
12437,1,18,4951.41,5,5,5,15
12438,14,2,2906.85,4,2,5,11
12441,366,1,173.55,1,1,1,3
12442,3,1,172.06,5,1,1,7
12444,21,5,5005.46,4,4,5,13
12445,22,1,133.4,4,1,1,6
12446,57,1,1002.3100000000001,3,1,4,8
12447,243,1,476.49,1,1,2,4
12448,44,1,449.45,3,1,2,6
12449,22,4,4067.29,4,4,5,13
12450,156,2,197.88,2,2,1,5
12451,10,5,9035.52,5,4,5,14
12452,16,2,430.57,4,2,2,8
12453,134,1,707.09,2,1,3,6
12454,56,1,3528.34,3,1,5,9
12455,73,6,2466.86,2,4,5,11
12456,44,3,3181.04,3,3,5,11
12457,66,7,2363.23,3,5,5,13
12458,71,2,947.4,3,2,4,9
12461,94,2,826.88,2,2,3,7
12462,18,2,1189.59,4,2,4,10
12463,53,4,1344.78,3,4,4,11
12464,10,8,1212.05,5,5,4,14
12465,17,2,742.1899999999999,4,2,3,9
12468,187,2,729.5400000000001,1,2,3,6
12471,2,30,19824.05,5,5,5,15
12472,32,7,6572.11,4,5,5,14
12473,29,5,3938.5499999999997,4,4,5,13
12474,17,18,7375.79,4,5,5,14
12475,53,1,723.38,3,1,3,7
12476,15,11,6816.42,4,5,5,14
12477,22,6,13219.74,4,4,5,13
12478,3,1,680.99,5,1,3,9
12479,11,1,527.2,5,1,3,9
12480,28,4,3281.63,4,4,5,13
12481,22,10,5596.32,4,5,5,14
12483,17,8,2484.98,4,5,5,14
12484,32,6,4541.72,4,4,5,13
12488,9,3,1298.66,5,3,4,12
12489,336,1,334.93,1,1,2,4
12490,5,10,5417.93,5,5,5,15
12491,38,1,460.40000000000003,3,1,2,6
12492,63,2,263.21000000000004,3,2,2,7
12493,165,2,433.74,2,2,2,6
12494,15,7,1246.1000000000001,4,5,4,13
12497,81,1,1043.1,2,1,4,7
12498,21,3,403.70000000000005,4,3,2,9
12500,23,11,4257.82,4,5,5,14
12501,336,1,2169.39,1,1,5,7
12502,95,5,3723.87,2,4,5,11
12504,18,2,482.04999999999995,4,2,2,8
12506,232,1,73.5,1,1,1,3
12507,134,3,1304.81,2,3,4,9
12508,26,2,398.27,4,2,2,8
12509,284,1,176.5,1,1,1,3
12510,142,2,982.5699999999999,2,2,4,8
12512,66,2,138.03,3,2,1,6
12513,112,1,612.29,2,1,3,6
12514,267,1,1017.68,1,1,4,6
12515,353,1,383.7,1,1,2,4
12516,77,2,1312.06,2,2,4,8
12517,28,5,2502.84,4,4,5,13
12518,0,5,2056.89,5,4,4,13
12519,63,1,340.84,3,1,2,6
12520,79,5,2634.26,2,4,5,11
12521,142,1,599.68,2,1,3,6
12522,39,2,192.72,3,2,1,6
12523,19,11,1789.77,4,5,4,13
12524,9,8,4485.72,5,5,5,15
12526,0,3,1316.66,5,3,4,12
12527,81,3,348.71000000000004,2,3,2,7
12528,9,6,1933.48,5,5,4,14
12530,59,4,1662.28,3,4,4,11
12531,14,1,125.22,4,1,1,6
12532,30,1,349.83000000000004,4,1,2,7
12534,130,1,1089.18,2,1,4,7
12535,91,2,716.35,2,2,3,7
12536,43,3,12601.830000000002,3,3,5,11
12538,29,1,363.95,4,1,2,7
12539,22,4,5568.35,4,4,5,13
12540,19,17,13400.24,4,5,5,14
12541,29,3,981.18,4,3,4,11
12544,36,1,372.7,3,1,2,6
12545,75,2,1000.39,2,2,4,8
12546,46,2,1161.5,3,2,4,9
12547,197,2,207.79999999999998,1,2,1,4
12548,166,1,95.19999999999999,2,1,1,4
12550,79,1,964.83,2,1,4,7
12551,357,1,168.0,1,1,1,3
12552,38,2,437.82,3,2,2,7
12553,8,10,3692.28,5,5,5,15
12556,50,2,603.71,3,2,3,8
12557,16,5,11990.960000000001,4,4,5,13
12558,7,1,269.96,5,1,2,8
12559,310,2,561.71,1,2,3,6
12560,5,3,2134.01,5,3,5,13
12561,302,1,238.85,1,1,1,3
12562,8,7,3781.7400000000002,5,5,5,15
12564,261,1,456.9,1,1,2,4
12565,288,1,145.92,1,1,1,3
12566,86,1,351.65,2,1,2,5
12567,22,10,9401.28,4,5,5,14
12569,2,32,4124.69,5,5,5,15
12571,39,2,519.61,3,2,3,8
12572,8,2,1020.42,5,2,4,11
12573,227,1,160.54000000000002,1,1,1,3
12574,315,1,218.45,1,1,1,3
12576,35,5,1315.83,3,4,4,11
12577,35,3,657.8,3,3,3,9
12578,21,2,2794.51,4,2,5,11
12579,78,1,440.42,2,1,2,5
12580,246,1,415.7,1,1,2,4
12581,39,1,197.71,3,1,1,5
12582,238,2,511.36,1,2,3,6
12583,2,15,7281.38,5,5,5,15
12584,3,9,2338.15,5,5,5,15
12585,234,2,2040.1,1,2,4,7
12586,17,1,196.94000000000003,4,1,1,6
12587,7,1,144.0,5,1,1,7
12588,39,1,214.89999999999998,3,1,1,5
12589,28,2,646.68,4,2,3,9
12590,211,2,9864.26,1,2,5,8
12591,317,1,452.84999999999997,1,1,2,4
12592,92,2,437.6,2,2,2,6
12593,108,3,418.09999999999997,2,3,2,7
12594,37,10,3338.2200000000003,3,5,5,13
12596,51,2,618.27,3,2,3,8
12597,19,4,3811.22,4,4,5,13
12598,9,8,3023.08,5,5,5,15
12599,29,7,1032.58,4,5,4,13
12600,28,10,2599.04,4,5,5,14
12601,189,5,577.0600000000001,1,4,3,8
12602,58,1,153.12,3,1,1,5
12603,21,1,739.1999999999999,4,1,3,8
12604,79,2,254.18,2,2,2,6
12607,60,1,1579.51,3,1,4,8
12609,78,3,1126.85,2,3,4,9
12610,22,5,2099.54,4,4,5,13
12611,52,1,1193.32,3,1,4,8
12612,74,1,704.0400000000001,2,1,3,6
12613,57,5,3344.38,3,4,5,12
12614,277,1,315.6,1,1,2,4
12615,2,4,2291.19,5,4,5,14
12616,95,2,713.3,2,2,3,7
12617,29,1,355.53,4,1,2,7
12618,21,1,177.31,4,1,1,6
12619,16,9,3641.24,4,5,5,14
12620,14,3,1339.41,4,3,4,11
12621,1,20,13689.67,5,5,5,15
12622,232,1,180.1,1,1,1,3
12623,276,1,305.1,1,1,2,4
12624,106,2,641.13,2,2,3,7
12625,211,2,2683.82,1,2,5,8
12626,23,9,6620.48,4,5,5,14
12627,10,7,4478.53,5,5,5,15
12628,4,3,786.46,5,3,3,11
12630,9,2,1270.88,5,2,4,11
12631,57,1,640.5,3,1,3,7
12633,58,4,2163.98,3,4,5,12
12635,89,2,1689.18,2,2,4,8
12637,67,8,6021.9,3,5,5,13
12638,33,1,671.69,3,1,3,7
12639,238,1,486.1,1,1,2,4
12640,23,3,1174.58,4,3,4,11
12641,115,1,185.9,2,1,1,4
12642,25,3,1013.26,4,3,4,11
12643,128,6,3344.64,2,5,5,12
12644,129,1,477.91,2,1,2,5
12645,33,4,1775.18,3,4,4,11
12646,4,2,1346.97,5,2,4,11
12647,22,12,3722.82,4,5,5,14
12648,154,1,318.05,2,1,2,5
12649,107,3,623.51,2,3,3,8
12650,3,1,314.44,5,1,2,8
12651,334,1,114.0,1,1,1,3
12652,331,1,919.98,1,1,3,5
12653,148,2,2209.85,2,2,5,9
12654,10,5,601.98,5,4,3,12
12656,17,5,4051.17,4,4,5,13
12657,11,4,1643.18,5,4,4,13
12658,18,1,686.05,4,1,3,8
12659,29,1,91.68,4,1,1,6
12660,11,1,245.1,5,1,1,7
12662,0,11,3849.78,5,5,5,15
12664,8,9,4881.88,5,5,5,15
12665,324,1,63.0,1,1,1,3
12667,58,1,620.13,3,1,3,7
12668,11,4,3807.15,5,4,5,14
12669,150,3,2744.0299999999997,2,3,5,10
12670,10,5,2996.05,5,4,5,14
12672,329,1,225.89999999999998,1,1,1,3
12673,5,2,610.52,5,2,3,10
12674,38,4,1970.6,3,4,4,11
12676,24,6,1331.39,4,5,4,13
12678,42,12,17628.46,3,5,5,13
12679,58,4,1113.02,3,4,4,11
12680,0,4,862.81,5,4,3,12
12681,14,22,13787.54,4,5,5,14
12682,3,31,12288.22,5,5,5,15
12683,4,15,8476.57,5,5,5,15
12684,7,7,2283.63,5,5,5,15
12685,28,6,2863.08,4,5,5,14
12686,371,1,89.14,1,1,1,3
12688,113,1,4873.8099999999995,2,1,5,8
12689,25,2,1247.61,4,2,4,10
12690,205,1,389.01,1,1,2,4
12691,28,6,1035.8,4,5,4,13
12693,127,4,855.91,2,4,3,9
12694,70,2,869.67,3,2,3,8
12695,7,4,582.1,5,4,3,12
12697,28,3,957.59,4,3,4,11
12700,7,4,4939.99,5,4,5,14
12701,79,2,797.71,2,2,3,7
12702,19,1,219.0,4,1,1,6
12703,71,1,283.55,3,1,2,6
12704,7,8,2340.84,5,5,5,15
12705,15,9,6868.29,4,5,5,14
12707,291,1,603.42,1,1,3,5
12708,29,10,2712.91,4,5,5,14
12709,15,15,9736.52,4,5,5,14
12710,96,3,1149.02,2,3,4,9
12712,28,13,4396.13,4,5,5,14
12713,0,1,848.55,5,1,3,9
12714,9,5,4708.86,5,4,5,14
12715,106,1,353.86,2,1,2,5
12716,3,2,1053.49,5,2,4,11
12717,151,2,1030.98,2,2,4,8
12718,71,1,238.25,3,1,1,5
12719,5,2,644.95,5,2,3,10
12720,2,25,5781.73,5,5,5,15
12721,31,6,2656.13,4,5,5,14
12722,85,4,997.63,2,4,4,10
12723,3,5,725.07,5,4,3,12
12724,5,4,1031.41,5,4,4,13
12725,371,1,427.8,1,1,2,4
12726,28,7,2609.1,4,5,5,14
12727,10,7,3980.7,5,5,5,15
12728,71,4,836.33,3,4,3,10
12729,113,1,453.01,2,1,2,5
12731,23,12,18895.91,4,5,5,14
12732,179,1,236.26000000000002,2,1,1,4
12733,234,1,383.95,1,1,2,4
12734,352,1,110.39999999999999,1,1,1,3
12735,315,2,779.5699999999999,1,2,3,6
12736,332,1,234.0,1,1,1,3
12738,372,1,155.35,1,1,1,3
12739,78,2,1013.04,2,2,4,8
12740,63,1,427.6,3,1,2,6
12743,134,2,546.43,2,2,3,7
12744,51,7,21279.29,3,5,5,13
12747,2,11,4196.01,5,5,5,15
12748,0,210,33719.73,5,5,5,15
12749,3,5,4090.88,5,4,5,14
12750,128,1,275.88,2,1,2,5
12752,81,1,4366.78,2,1,5,8
12753,22,6,21429.39,4,5,5,14
12754,235,3,3010.74,1,3,5,9
12755,280,2,3811.95,1,2,5,8
12756,86,1,112.07999999999998,2,1,1,4
12757,15,13,7857.1,4,5,5,14
12758,116,2,2791.59,2,2,5,9
12759,52,3,1531.44,3,3,4,10
12762,7,2,1898.52,5,2,4,11
12763,138,2,494.08,2,2,3,7
12764,316,1,1693.88,1,1,4,6
12766,3,7,6989.63,5,5,5,15
12769,238,1,1143.6,1,1,4,6
12770,210,1,1351.45,1,1,4,6
12772,59,1,892.47,3,1,3,7
12775,17,5,1386.04,4,4,4,12
12778,19,6,822.23,4,5,3,12
12779,37,8,3981.36,3,5,5,13
12781,63,2,826.74,3,2,3,8
12782,4,5,2330.92,5,4,5,14
12783,2,6,2225.91,5,5,5,15
12784,9,2,574.42,5,2,3,10
12785,364,1,311.95,1,1,2,4
12787,9,3,463.66,5,3,2,10
12789,65,1,91.85,3,1,1,5
12790,192,1,324.92,1,1,2,4
12791,373,1,192.60000000000002,1,1,1,3
12792,256,1,400.53999999999996,1,1,2,4
12793,334,2,545.48,1,2,3,6
12794,53,2,860.41,3,2,3,8
12795,18,1,430.48,4,1,2,7
12797,365,1,254.03,1,1,2,4
12798,10,3,6977.04,5,3,5,13
12802,186,1,427.58,1,1,2,4
12808,36,3,483.65000000000003,3,3,2,8
12809,177,1,489.31,2,1,2,5
12811,260,3,514.85,1,3,3,7
12812,44,1,229.64000000000001,3,1,1,5
12814,101,1,125.92,2,1,1,4
12815,147,2,1063.46,2,2,4,8
12816,95,2,572.2,2,2,3,7
12817,281,1,166.04,1,1,1,3
12818,261,1,1542.08,1,1,4,6
12820,3,4,942.34,5,4,4,13
12821,214,1,92.72,1,1,1,3
12822,70,2,948.88,3,2,4,9
12823,74,5,1759.5,2,4,4,10
12824,59,1,397.12,3,1,2,6
12826,2,7,1474.72,5,5,4,14
12827,5,3,430.15000000000003,5,3,2,10
12828,2,6,1018.71,5,5,4,14
12829,336,2,293.0,1,2,2,5
12830,37,6,6814.64,3,5,5,13
12831,262,1,215.05,1,1,1,3
12832,32,2,383.03,4,2,2,8
12833,145,1,417.38,2,1,2,5
12834,282,1,312.38,1,1,2,4
12836,59,4,2612.86,3,4,5,12
12837,173,1,134.1,2,1,1,4
12838,33,2,683.13,3,2,3,8
12839,2,14,5591.42,5,5,5,15
12840,143,4,2726.77,2,4,5,11
12841,4,25,4022.35,5,5,5,15
12842,70,2,1118.99,3,2,4,9
12843,65,8,1702.26,3,5,4,12
12844,29,2,325.96000000000004,4,2,2,8
12845,267,4,354.09,1,4,2,7
12847,22,1,871.54,4,1,3,8
12849,31,2,1050.8899999999999,4,2,4,10
12851,96,1,135.18,2,1,1,4
12852,294,1,311.55,1,1,2,4
12853,134,6,1957.1000000000001,2,5,4,11
12854,78,3,1324.5,2,3,4,9
12855,372,1,38.1,1,1,1,3
12856,7,6,2179.93,5,5,5,15
12857,210,2,1106.4,1,2,4,7
12863,52,1,521.2,3,1,3,7
12864,138,1,147.12,2,1,1,4
12865,26,2,1568.23,4,2,4,10
12866,283,1,559.12,1,1,3,5
12867,26,7,4036.82,4,5,5,14
12868,185,6,1607.0600000000002,1,5,4,10
12871,84,2,380.64,2,2,2,6
12872,326,2,599.97,1,2,3,6
12873,282,1,374.0,1,1,2,4
12875,143,2,343.2300000000001,2,2,2,6
12876,57,2,2218.02,3,2,5,10
12877,3,12,1535.77,5,5,4,14
12878,236,2,854.99,1,2,3,6
12879,44,3,573.22,3,3,3,9
12881,275,1,298.0,1,1,2,4
12882,9,2,1463.04,5,2,4,11
12883,24,4,703.47,4,4,3,11
12884,88,1,309.05,2,1,2,5
12885,63,3,1175.22,3,3,4,10
12886,67,2,1378.4,3,2,4,9
12888,214,2,354.12,1,2,2,5
12890,24,1,380.46999999999997,4,1,2,7
12891,185,3,331.0,1,3,2,6
12893,30,1,188.14,4,1,1,6
12895,42,2,372.8,3,2,2,7
12897,204,2,216.5,1,2,1,4
12901,8,28,17654.54,5,5,5,15
12902,264,1,138.68,1,1,1,3
12904,18,2,509.58,4,2,3,9
12906,11,5,2919.81,5,4,5,14
12908,176,2,750.0,2,2,3,7
12909,39,5,2178.67,3,4,5,12
12910,23,8,3075.04,4,5,5,14
12912,2,5,1662.3,5,4,4,13
12913,4,5,2483.63,5,4,5,14
12915,148,2,363.65,2,2,2,6
12916,138,4,3006.15,2,4,5,11
12917,128,1,594.0,2,1,3,6
12919,8,6,1335.19,5,5,4,14
12920,17,1,164.23,4,1,1,6
12921,9,37,16587.09,5,5,5,15
12922,161,1,405.38,2,1,2,5
12923,64,1,176.97,3,1,1,5
12924,88,4,933.7,2,4,3,9
12925,4,2,694.05,5,2,3,10
12928,35,5,2062.7000000000003,3,4,5,12
12929,311,1,117.85,1,1,1,3
12930,78,2,415.8,2,2,2,6
12931,21,15,42055.96,4,5,5,14
12933,24,3,607.53,4,3,3,10
12935,2,7,2160.7,5,5,5,15
12936,17,4,1063.9,4,4,4,12
12937,15,4,1504.27,4,4,4,12
12938,25,1,114.14,4,1,1,6
12939,64,8,11581.8,3,5,5,13
12940,54,2,913.54,3,2,3,8
12942,131,3,683.9,2,3,3,8
12944,35,2,604.51,3,2,3,8
12945,288,1,462.95,1,1,2,4
12947,143,6,1603.99,2,5,4,11
12948,16,7,2064.95,4,5,5,14
12949,30,8,4167.22,4,5,5,14
12950,2,3,1843.0,5,3,4,12
12951,8,6,1064.07,5,5,4,14
12952,5,4,1387.79,5,4,4,13
12953,9,1,329.85,5,1,2,8
12955,1,11,4757.16,5,5,5,15
12956,306,1,108.07,1,1,1,3
12957,9,8,4017.54,5,5,5,15
12962,7,2,266.39,5,2,2,9
12963,8,8,1856.63,5,5,4,14
12965,89,1,771.91,2,1,3,6
12966,9,1,160.18,5,1,1,7
12967,358,2,1660.9,1,2,4,7
12968,112,1,135.95,2,1,1,4
12970,7,4,452.24,5,4,2,11
12971,3,86,11189.91,5,5,5,15
12974,197,1,144.8,1,1,1,3
12976,211,1,738.6,1,1,3,5
12977,156,1,39.239999999999995,2,1,1,4
12980,157,9,7374.900000000001,2,5,5,12
12981,29,2,372.21999999999997,4,2,2,8
12982,242,1,390.54,1,1,2,4
12984,18,1,97.5,4,1,1,6
12985,0,2,1239.38,5,2,4,11
12987,73,2,558.7,2,2,3,7
12988,292,1,535.32,1,1,3,5
12989,3,15,6924.110000000001,5,5,5,15
12990,31,3,409.5,4,3,2,9
12991,23,2,503.76,4,2,3,9
12993,23,4,414.76,4,4,2,10
12994,4,3,974.4200000000001,5,3,4,12
12995,85,1,211.32,2,1,1,4
12997,22,4,1226.89,4,4,4,12
12999,196,3,455.88,1,3,2,6
13000,106,3,534.85,2,3,3,8
13001,4,13,9818.82,5,5,5,15
13002,318,1,120.94999999999999,1,1,1,3
13003,105,3,149.05,2,3,1,6
13004,11,18,5655.91,5,5,5,15
13005,173,2,513.7,2,2,3,7
13006,56,1,81.57,3,1,1,5
13008,323,1,229.46999999999997,1,1,1,3
13011,372,1,50.550000000000004,1,1,1,3
13012,9,8,1661.8400000000001,5,5,4,14
13013,1,13,4810.9400000000005,5,5,5,15
13014,10,10,3466.2799999999997,5,5,5,15
13015,53,5,3346.28,3,4,5,12
13016,73,3,789.89,2,3,3,8
13017,7,1,204.0,5,1,1,7
13018,16,28,7277.7,4,5,5,14
13021,4,9,2616.38,5,5,5,15
13023,64,2,689.9,3,2,3,8
13026,1,5,975.36,5,4,4,13
13027,113,6,6912.0,2,5,5,12
13028,22,2,661.3199999999999,4,2,3,9
13029,30,3,1247.5,4,3,4,11
13030,11,2,799.48,5,2,3,10
13032,52,2,1010.18,3,2,4,9
13033,357,1,190.55,1,1,1,3
13034,54,2,642.77,3,2,3,8
13035,73,2,921.88,2,2,3,7
13037,138,3,881.07,2,3,3,8
13038,80,3,908.46,2,3,3,8
13040,8,2,676.99,5,2,3,10
13043,273,1,516.42,1,1,3,5
13044,291,1,560.47,1,1,3,5
13045,99,1,305.28000000000003,2,1,2,5
13046,30,2,629.31,4,2,3,9
13047,31,10,3237.54,4,5,5,14
13048,14,4,1835.91,4,4,4,12
13049,64,2,656.6800000000001,3,2,3,8
13050,14,17,5836.86,4,5,5,14
13052,212,1,348.15000000000003,1,1,2,4
13055,78,3,1214.41,2,3,4,9
13058,24,3,271.40000000000003,4,3,2,9
13059,249,1,183.4,1,1,1,3
13060,253,1,307.53,1,1,2,4
13061,72,1,248.61,2,1,1,4
13062,191,1,346.98,1,1,2,4
13064,12,4,1119.49,5,4,4,13
13065,373,1,205.86,1,1,1,3
13066,24,2,470.8,4,2,2,8
13067,82,1,115.46000000000001,2,1,1,4
13068,10,2,344.0,5,2,2,9
13069,0,24,4436.12,5,5,5,15
13070,192,1,228.8,1,1,1,3
13072,266,1,177.15,1,1,1,3
13075,129,1,919.61,2,1,3,6
13077,1,4,729.27,5,4,3,12
13078,3,26,12627.94,5,5,5,15
13079,4,5,220.10000000000002,5,4,1,10
13080,179,1,58.08,2,1,1,4
13081,11,11,28337.38,5,5,5,15
13082,126,9,3613.63,2,5,5,12
13083,4,2,303.75,5,2,2,9
13085,157,2,416.08000000000004,2,2,2,6
13089,2,97,58825.83,5,5,5,15
13090,8,14,8910.82,5,5,5,15
13091,28,1,345.82,4,1,2,7
13092,70,5,477.83,3,4,2,9
13093,275,8,7832.47,1,5,5,11
13094,21,12,1927.3200000000002,4,5,4,13
13095,70,1,74.39999999999999,3,1,1,5
13097,32,10,6010.42,4,5,5,14
13098,1,28,28882.44,5,5,5,15
13099,99,1,207.35999999999999,2,1,1,4
13101,234,1,101.19,1,1,1,3
13102,1,24,6424.09,5,5,5,15
13103,39,1,243.94,3,1,1,5
13104,3,6,1098.48,5,5,4,14
13106,133,1,76.5,2,1,1,4
13107,44,4,1531.6200000000001,3,4,4,11
13108,372,1,350.06,1,1,2,4
13109,59,2,786.54,3,2,3,8
13110,31,7,1488.67,4,5,4,13
13113,0,24,12245.960000000001,5,5,5,15
13115,11,4,2294.78,5,4,5,14
13116,138,1,501.14,2,1,3,6
13117,21,8,984.91,4,5,4,13
13118,19,5,1197.81,4,4,4,12
13120,238,1,30.599999999999998,1,1,1,3
13121,269,1,283.73,1,1,2,4
13122,94,2,922.39,2,2,3,7
13124,89,3,3866.33,2,3,5,10
13126,4,8,2099.64,5,5,5,15
13127,77,1,259.17,2,1,2,5
13130,94,1,64.0,2,1,1,4
13131,23,3,1073.3,4,3,4,11
13132,261,1,77.3,1,1,1,3
13133,273,2,109.8,1,2,1,4
13134,85,4,1793.58,2,4,4,10
13135,196,1,3096.0,1,1,5,7
13136,56,5,2607.61,3,4,5,12
13137,10,8,3650.41,5,5,5,15
13138,22,6,962.39,4,5,4,13
13139,16,7,5064.94,4,5,5,14
13140,108,3,423.72,2,3,2,7
13141,84,5,2388.75,2,4,5,11
13142,19,1,307.09,4,1,2,7
13144,332,1,110.95,1,1,1,3
13145,39,4,618.52,3,4,3,10
13146,26,1,228.91,4,1,1,6
13147,10,4,712.8000000000001,5,4,3,12
13148,29,12,3707.12,4,5,5,14
13149,14,4,1676.06,4,4,4,12
13151,295,1,1257.8700000000001,1,1,4,6
13153,5,1,486.22,5,1,2,8
13155,33,4,971.76,3,4,4,11
13157,49,4,1741.22,3,4,4,11
13158,94,4,1201.06,2,4,4,10
13159,8,4,1437.85,5,4,4,13
13160,22,1,91.8,4,1,1,6
13161,313,1,112.75,1,1,1,3
13162,122,4,1688.29,2,4,4,10
13165,46,2,1021.48,3,2,4,9
13166,283,1,417.2,1,1,2,4
13167,18,4,791.33,4,4,3,11
13168,36,4,1319.19,3,4,4,11
13169,63,2,712.88,3,2,3,8
13170,26,1,116.00999999999999,4,1,1,6
13171,21,3,468.41,4,3,2,9
13173,4,2,353.65,5,2,2,9
13174,16,3,2817.03,4,3,5,12
13176,46,1,492.84,3,1,3,7
13177,64,1,282.45,3,1,2,6
13178,26,11,5725.47,4,5,5,14
13182,45,1,121.18,3,1,1,5
13183,7,9,3957.78,5,5,5,15
13184,14,10,1701.29,4,5,4,13
13185,267,1,71.4,1,1,1,3
13186,39,3,1575.89,3,3,4,10
13187,337,1,236.02,1,1,1,3
13188,11,1,114.60000000000001,5,1,1,7
13189,18,2,260.68,4,2,2,8
13192,95,2,911.94,2,2,3,7
13193,61,1,117.88,3,1,1,5
13194,135,1,60.7,2,1,1,4
13196,11,4,1797.78,5,4,4,13
13198,10,6,3401.2400000000002,5,5,5,15
13199,3,38,9817.12,5,5,5,15
13200,19,4,870.09,4,4,3,11
13203,9,4,869.46,5,4,3,12
13207,15,2,250.26000000000002,4,2,2,8
13208,58,6,1223.9,3,5,4,12
13209,30,8,5891.61,4,5,5,14
13210,93,1,353.48,2,1,2,5
13211,10,3,1197.42,5,3,4,12
13212,19,3,788.08,4,3,3,10
13213,56,5,1520.58,3,4,4,11
13216,267,1,333.74,1,1,2,4
13217,122,3,533.98,2,3,3,8
13218,127,1,62.63999999999999,2,1,1,4
13220,78,4,819.2900000000001,2,4,3,9
13221,240,2,847.41,1,2,3,6
13223,200,2,163.20000000000002,1,2,1,4
13224,60,2,2155.95,3,2,5,10
13225,3,7,6463.84,5,5,5,15
13226,273,1,108.21000000000001,1,1,1,3
13227,201,1,257.7,1,1,2,4
13228,81,1,358.0,2,1,2,5
13229,225,1,160.95,1,1,1,3
13230,4,14,2806.97,5,5,5,15
13232,12,7,1357.6,5,5,4,14
13233,74,2,605.12,2,2,3,7
13235,212,1,1031.07,1,1,4,6
13236,24,2,744.85,4,2,3,9
13238,17,4,700.73,4,4,3,11
13239,261,1,329.56,1,1,2,4
13240,96,4,663.65,2,4,3,9
13242,112,3,270.40000000000003,2,3,2,7
13243,203,1,600.07,1,1,3,5
13244,92,1,121.74000000000001,2,1,1,4
13245,50,1,430.5,3,1,2,6
13246,18,6,1987.3,4,5,4,13
13247,17,4,501.12,4,4,3,11
13248,124,2,465.68,2,2,2,6
13249,92,3,711.41,2,3,3,8
13253,156,2,1030.4,2,2,4,8
13255,9,2,399.51,5,2,2,9
13256,14,1,0.0,4,1,1,6
13258,11,3,698.58,5,3,3,11
13259,61,1,292.32,3,1,2,6
13260,61,1,557.62,3,1,3,7
13261,268,2,944.1,1,2,4,7
13262,263,1,200.29,1,1,1,3
13263,1,35,7454.07,5,5,5,15
13265,53,5,2107.66,3,4,5,12
13266,11,12,3834.2599999999998,5,5,5,15
13267,2,19,4521.49,5,5,5,15
13268,17,11,3214.69,4,5,5,14
13269,1,15,5346.2300000000005,5,5,5,15
13270,366,1,590.0,1,1,3,5
13271,37,1,217.38,3,1,1,5
13272,31,2,276.56,4,2,2,8
13273,113,1,138.98,2,1,1,4
13276,63,2,590.9300000000001,3,2,3,8
13277,15,4,258.4,4,4,2,10
13278,40,1,542.73,3,1,3,7
13279,78,1,137.75,2,1,1,4
13280,122,3,814.86,2,3,3,8
13282,18,3,1132.14,4,3,4,11
13283,59,2,93.66,3,2,1,6
13284,330,1,201.19,1,1,1,3
13285,23,4,2709.12,4,4,5,13
13291,155,1,361.11,2,1,2,5
13292,38,2,578.9399999999999,3,2,3,8
13294,189,2,873.74,1,2,3,6
13295,359,1,201.20000000000002,1,1,1,3
13296,137,1,87.4,2,1,1,4
13297,7,4,2089.85,5,4,5,14
13298,1,1,360.0,5,1,2,8
13299,268,1,142.5,1,1,1,3
13300,169,1,371.89,2,1,2,5
13301,103,4,618.09,2,4,3,9
13302,155,1,63.75,2,1,1,4
13304,351,1,300.42,1,1,2,4
13305,4,10,2000.86,5,5,4,14
13307,120,1,15.0,2,1,1,4
13308,22,3,1385.51,4,3,4,11
13309,7,5,1456.79,5,4,4,13
13310,28,3,1132.03,4,3,4,11
13311,4,2,598.57,5,2,3,10
13313,22,5,1555.32,4,4,4,12
13314,1,3,775.94,5,3,3,11
13316,37,4,5977.7300000000005,3,4,5,12
13317,66,6,2273.68,3,5,5,13
13318,1,3,640.76,5,3,3,11
13319,5,26,10845.550000000001,5,5,5,15
13320,78,4,1548.7,2,4,4,10
13321,72,2,567.36,2,2,3,7
13322,17,1,199.48000000000002,4,1,1,6
13323,3,5,787.85,5,4,3,12
13324,36,10,7121.95,3,5,5,13
13325,81,1,675.3,2,1,3,6
13327,38,8,3627.77,3,5,5,13
13328,316,1,1308.48,1,1,4,6
13329,31,2,789.0,4,2,3,9
13330,92,3,1140.93,2,3,4,9
13332,14,1,350.9,4,1,2,7
13334,82,3,3536.82,2,3,5,10
13336,77,1,795.12,2,1,3,6
13338,157,1,487.02,2,1,2,5
13339,200,1,860.12,1,1,3,5
13340,45,7,10736.48,3,5,5,13
13341,260,1,775.85,1,1,3,5
13343,177,1,353.43,2,1,2,5
13344,67,3,2543.72,3,3,5,11
13345,287,1,389.5,1,1,2,4
13347,70,1,341.36,3,1,2,6
13348,64,1,233.76,3,1,1,5
13349,10,1,247.32,5,1,1,7
13350,16,2,979.12,4,2,4,10
13351,66,1,373.94,3,1,2,6
13352,60,1,397.97999999999996,3,1,2,6
13354,71,1,743.53,3,1,3,7
13355,122,1,674.7,2,1,3,6
13356,80,1,768.24,2,1,3,6
13357,257,1,609.95,1,1,3,5
13358,268,1,439.03,1,1,2,4
13359,63,1,439.56,3,1,2,6
13362,9,4,3090.7400000000002,5,4,5,14
13363,17,2,992.5,4,2,4,10
13364,71,1,134.95999999999998,3,1,1,5
13365,33,2,2225.37,3,2,5,10
13366,50,1,56.160000000000004,3,1,1,5
13368,256,2,623.4,1,2,3,6
13369,365,1,308.28000000000003,1,1,2,4
13370,371,1,754.87,1,1,3,5
13372,89,1,378.64,2,1,2,5
13373,60,3,3312.25,3,3,5,11
13375,88,1,778.65,2,1,3,6
13376,99,3,1019.76,2,3,4,9
13379,26,3,572.56,4,3,3,10
13381,31,6,3639.31,4,5,5,14
13382,280,1,222.99,1,1,1,3
13384,30,7,4151.93,4,5,5,14
13385,329,1,534.57,1,1,3,5
13388,131,2,677.1,2,2,3,7
13389,11,3,797.96,5,3,3,11
13390,74,1,544.08,2,1,3,6
13391,203,1,59.8,1,1,1,3
13394,1,8,2520.02,5,5,5,15
13395,185,1,307.72,1,1,2,4
13396,29,2,1360.99,4,2,4,10
13397,72,5,1544.13,2,4,4,10
13398,192,1,457.34,1,1,2,4
13402,127,2,621.23,2,2,3,7
13403,17,1,75.0,4,1,1,6
13404,1,2,252.49,5,2,2,9
13405,74,3,572.451,2,3,3,8
13408,1,62,28117.04,5,5,5,15
13410,24,5,1003.06,4,4,4,12
13411,107,1,213.55,2,1,1,4
13414,133,3,1390.5,2,3,4,9
13416,43,2,712.5,3,2,3,8
13417,4,2,640.83,5,2,3,10
13418,11,18,6127.43,5,5,5,15
13419,63,1,221.06,3,1,1,5
13420,149,2,159.85,2,2,1,5
13421,40,2,1851.08,3,2,4,9
13422,64,1,2626.3,3,1,5,9
13425,108,3,1624.21,2,3,4,9
13426,0,10,3641.32,5,5,5,15
13427,19,3,582.6,4,3,3,10
13428,10,1,218.47,5,1,1,7
13429,10,4,1006.8,5,4,4,13
13430,18,2,679.45,4,2,3,9
13431,67,2,1269.1,3,2,4,9
13434,74,2,534.24,2,2,3,7
13435,5,7,3809.8900000000003,5,5,5,15
13436,1,1,196.89,5,1,1,7
13437,14,7,3408.06,4,5,5,14
13439,255,1,283.71,1,1,2,4
13441,91,1,296.64,2,1,2,5
13447,23,3,1129.14,4,3,4,11
13448,16,6,3539.37,4,5,5,14
13449,23,1,291.88,4,1,2,7
13450,26,6,2043.7199999999998,4,5,4,13
13451,26,5,2976.15,4,4,5,13
13452,259,2,590.0,1,2,3,6
13453,165,2,356.97999999999996,2,2,2,6
13455,24,2,1058.34,4,2,4,10
13456,17,6,1766.72,4,5,4,13
13458,7,14,9646.57,5,5,5,15
13460,29,2,183.44,4,2,1,7
13461,38,3,1445.0,3,3,4,10
13462,252,1,151.5,1,1,1,3
13464,58,1,674.68,3,1,3,7
13466,184,1,307.9,1,1,2,4
13467,10,2,1083.71,5,2,4,11
13468,1,37,5704.97,5,5,5,15
13470,99,2,165.0,2,2,1,5
13471,1,4,2531.58,5,4,5,14
13473,60,2,422.64,3,2,2,7
13474,236,1,229.59,1,1,1,3
13475,191,4,1431.78,1,4,4,9
13476,178,2,1238.47,2,2,4,8
13477,37,6,1454.58,3,5,4,12
13479,200,2,300.95,1,2,2,5
13481,45,5,1804.56,3,4,4,11
13482,232,1,184.64,1,1,1,3
13483,65,1,140.34,3,1,1,5
13484,241,1,313.8,1,1,2,4
13485,233,1,454.24,1,1,2,4
13486,78,3,1122.41,2,3,4,9
13487,57,3,575.4,3,3,3,9
13488,17,13,8968.31,4,5,5,14
13489,105,4,449.52,2,4,2,8
13491,51,10,1215.82,3,5,4,12
13492,136,3,1269.84,2,3,4,9
13493,275,2,618.63,1,2,3,6
13494,311,1,316.26000000000005,1,1,2,4
13495,7,5,2044.8700000000001,5,4,4,13
13496,10,2,653.33,5,2,3,10
13497,282,2,348.05,1,2,2,5
13499,17,5,1159.11,4,4,4,12
13500,23,3,1166.77,4,3,4,11
13501,288,1,1340.32,1,1,4,6
13502,16,3,292.0,4,3,2,9
13503,71,1,216.85,3,1,1,5
13504,64,1,295.93,3,1,2,6
13505,72,4,4393.63,2,4,5,11
13506,316,2,458.52,1,2,2,5
13507,3,4,2479.16,5,4,5,14
13508,243,1,110.97,1,1,1,3
13509,8,7,979.72,5,5,4,14
13510,1,4,1791.56,5,4,4,13
13512,260,1,251.21,1,1,2,4
13513,126,1,205.1,2,1,1,4
13514,73,1,152.20000000000002,2,1,1,4
13515,72,4,891.12,2,4,3,9
13516,21,3,1389.41,4,3,4,11
13517,59,3,2128.42,3,3,5,11
13518,85,1,659.4399999999999,2,1,3,6
13519,78,1,122.75,2,1,1,4
13520,58,6,3624.35,3,5,5,13
13521,1,3,1093.65,5,3,4,12
13522,30,1,125.80000000000001,4,1,1,6
13523,33,5,3964.88,3,4,5,12
13524,40,5,680.1800000000001,3,4,3,10
13525,14,2,628.78,4,2,3,9
13527,33,7,2287.51,3,5,5,13
13529,78,2,307.76,2,2,2,6
13531,205,2,483.8,1,2,2,5
13532,33,1,210.31,3,1,1,5
13533,182,3,270.79,1,3,2,6
13534,2,25,5870.08,5,5,5,15
13536,1,7,3448.29,5,5,5,15
13538,43,7,1280.85,3,5,4,12
13539,85,3,631.34,2,3,3,8
13544,39,2,291.41,3,2,2,7
13546,12,3,626.99,5,3,3,11
13548,96,2,682.41,2,2,3,7
13549,25,7,918.2,4,5,3,12
13551,319,1,91.80000000000001,1,1,1,3
13552,66,12,3740.07,3,5,5,13
13555,73,4,4149.28,2,4,5,11
13557,28,2,584.06,4,2,3,9
13558,5,4,605.06,5,4,3,12
13560,7,1,174.37,5,1,1,7
13561,215,1,141.85999999999999,1,1,1,3
13562,81,3,1799.33,2,3,4,9
13563,84,2,777.53,2,2,3,7
13564,144,3,1749.02,2,3,4,9
13565,19,2,240.22,4,2,1,7
13566,40,2,874.71,3,2,3,8
13568,173,1,192.85,2,1,1,4
13569,17,2,373.75,4,2,2,8
13570,243,1,239.49,1,1,1,3
13571,12,12,2092.32,5,5,5,15
13572,205,1,1384.25,1,1,4,6
13573,50,2,294.4,3,2,2,7
13575,23,5,732.0699999999999,4,4,3,11
13576,10,18,6717.34,5,5,5,15
13577,25,4,1687.6000000000001,4,4,4,12
13579,14,2,467.04,4,2,2,8
13581,309,1,118.0,1,1,1,3
13583,155,1,781.03,2,1,3,6
13584,306,1,142.4,1,1,1,3
13587,63,1,712.4,3,1,3,7
13588,15,9,2478.95,4,5,5,14
13589,14,2,379.65,4,2,2,8
13590,11,6,1981.92,5,5,4,14
13591,64,3,1117.13,3,3,4,10
13592,35,4,247.95999999999998,3,4,1,8
13593,108,5,2037.0800000000002,2,4,4,10
13594,52,1,396.97,3,1,2,6
13596,5,2,697.04,5,2,3,10
13598,47,1,180.17000000000002,3,1,1,5
13599,1,21,5153.67,5,5,5,15
13600,312,1,219.52,1,1,1,3
13601,45,2,693.32,3,2,3,8
13602,64,1,428.89,3,1,2,6
13603,26,1,164.34,4,1,1,6
13606,29,3,280.53999999999996,4,3,2,9
13607,40,1,678.01,3,1,3,7
13610,12,7,1131.88,5,5,4,14
13611,89,3,1171.8,2,3,4,9
13614,24,4,1610.46,4,4,4,12
13615,318,1,417.69,1,1,2,4
13617,40,3,544.18,3,3,3,9
13618,173,1,177.34,2,1,1,4
13621,116,1,213.85,2,1,1,4
13623,30,5,747.78,4,4,3,11
13626,252,1,257.23,1,1,2,4
13627,59,5,1638.47,3,4,4,11
13629,23,11,7792.36,4,5,5,14
13630,5,7,2031.78,5,5,4,14
13631,99,11,3070.42,2,5,5,12
13632,24,5,2121.27,4,4,5,13
13634,33,5,1575.16,3,4,4,11
13635,67,1,1071.03,3,1,4,8
13636,36,5,949.12,3,4,4,11
13637,52,3,810.5,3,3,3,9
13638,15,1,122.64,4,1,1,6
13639,74,1,1033.34,2,1,4,7
13642,215,1,354.8,1,1,2,4
13643,31,3,519.44,4,3,3,10
13644,16,4,2624.26,4,4,5,13
13645,120,1,252.1,2,1,2,5
13647,9,4,1678.1200000000001,5,4,4,13
13649,256,2,346.6,1,2,2,5
13650,16,6,1836.34,4,5,4,13
13651,35,2,94.2,3,2,1,6
13652,45,3,1095.08,3,3,4,10
13654,43,6,2707.33,3,5,5,13
13655,114,2,932.97,2,2,3,7
13656,164,2,379.65,2,2,2,6
13657,10,2,382.14,5,2,2,9
13658,9,5,2639.17,5,4,5,14
13659,205,2,1573.2,1,2,4,7
13662,85,3,897.76,2,3,3,8
13663,179,1,189.47,2,1,1,4
13666,60,3,84.65,3,3,1,7
13667,149,1,305.02,2,1,2,5
13668,2,21,6363.59,5,5,5,15
13669,50,2,218.55,3,2,1,6
13670,75,1,349.7,2,1,2,5
13672,301,2,186.39000000000001,1,2,1,4
13673,18,2,396.92,4,2,2,8
13675,151,2,486.82000000000005,2,2,2,6
13678,151,1,232.6,2,1,1,4
13680,1,4,3722.42,5,4,5,14
13681,17,4,827.83,4,4,3,11
13682,187,1,59.5,1,1,1,3
13684,285,1,67.23,1,1,1,3
13685,2,7,3119.44,5,5,5,15
13686,182,1,72.0,1,1,1,3
13689,63,1,910.0,3,1,3,7
13690,59,1,172.25,3,1,1,5
13692,24,3,1488.32,4,3,4,11
13694,3,50,65039.62,5,5,5,15
13695,31,15,2504.13,4,5,5,14
13697,38,1,151.29999999999998,3,1,1,5
13699,155,1,308.58000000000004,2,1,2,5
13700,26,10,2265.12,4,5,5,14
13703,318,1,99.5,1,1,1,3
13704,5,9,2308.06,5,5,5,15
13705,7,3,711.86,5,3,3,11
13706,302,1,330.79,1,1,2,4
13707,267,2,806.41,1,2,3,6
13708,271,1,296.88,1,1,2,4
13709,3,13,6328.05,5,5,5,15
13710,31,1,180.48,4,1,1,6
13711,218,2,252.06,1,2,2,5
13712,246,1,228.84,1,1,1,3
13715,281,5,1079.34,1,4,4,9
13716,269,1,138.28,1,1,1,3
13717,32,6,1445.01,4,5,4,13
13718,246,2,306.55,1,2,2,5
13719,15,5,1041.68,4,4,4,12
13720,116,4,799.9,2,4,3,9
13721,36,1,524.14,3,1,3,7
13722,131,3,2375.41,2,3,5,10
13723,217,1,199.85000000000002,1,1,1,3
13725,49,8,1980.56,3,5,4,12
13726,38,2,1079.6599999999999,3,2,4,9
13727,28,2,333.48,4,2,2,8
13728,36,6,1016.14,3,5,4,12
13730,135,2,752.6,2,2,3,7
13731,219,2,610.59,1,2,3,6
13732,28,1,491.86,4,1,3,8
13735,24,4,2885.2400000000002,4,4,5,13
13736,5,2,731.9,5,2,3,10
13737,200,1,339.59999999999997,1,1,2,4
13739,18,1,216.9,4,1,1,6
13740,240,1,350.75,1,1,2,4
13741,71,3,668.4300000000001,3,3,3,9
13742,16,12,3131.02,4,5,5,14
13743,2,7,1341.6,5,5,4,14
13744,95,2,1156.36,2,2,4,8
13745,162,1,300.04,2,1,2,5
13747,373,1,79.6,1,1,1,3
13748,95,5,948.25,2,4,4,10
13750,53,5,1647.26,3,4,4,11
13751,288,1,296.25,1,1,2,4
13752,124,6,1186.28,2,5,4,11
13753,287,1,741.26,1,1,3,5
13754,151,2,282.59999999999997,2,2,2,6
13755,3,9,2161.35,5,5,5,15
13756,2,14,5189.52,5,5,5,15
13758,11,7,3190.55,5,5,5,15
13759,33,2,659.4100000000001,3,2,3,8
13760,54,2,286.79,3,2,2,7
13761,50,2,1070.65,3,2,4,9
13762,218,1,306.72,1,1,2,4
13763,63,1,1714.96,3,1,4,8
13764,70,3,1521.76,3,3,4,10
13767,2,37,17220.36,5,5,5,15
13769,2,10,2796.51,5,5,5,15
13771,64,4,2634.45,3,4,5,12
13772,33,3,1132.13,3,3,4,10
13774,81,1,345.0,2,1,2,5
13777,0,33,25977.16,5,5,5,15
13778,103,1,178.7,2,1,1,4
13780,7,2,360.01,5,2,2,9
13781,250,1,127.84,1,1,1,3
13782,12,6,912.0,5,5,3,13
13784,9,11,2462.79,5,5,5,15
13786,367,1,230.39999999999998,1,1,1,3
13787,75,2,309.04,2,2,2,6
13790,4,1,348.8,5,1,2,8
13791,127,2,1516.0,2,2,4,8
13792,66,2,195.55,3,2,1,6
13798,1,57,37153.85,5,5,5,15
13799,116,2,688.86,2,2,3,7
13800,309,1,558.32,1,1,3,5
13801,66,1,324.8,3,1,2,6
13802,138,3,4599.42,2,3,5,10
13803,255,1,277.07,1,1,2,4
13804,30,7,2635.79,4,5,5,14
13805,52,2,924.6,3,2,3,8
13806,63,1,256.38,3,1,2,6
13807,367,1,112.6,1,1,1,3
13808,5,5,1747.66,5,4,4,13
13809,305,1,155.05,1,1,1,3
13810,28,3,1499.01,4,3,4,11
13811,183,3,814.5,1,3,3,7
13812,42,3,539.0,3,3,3,9
13813,39,4,1366.8600000000001,3,4,4,11
13814,92,2,1579.12,2,2,4,8
13815,22,4,4027.36,4,4,5,13
13816,23,2,571.6700000000001,4,2,3,9
13817,29,2,382.98,4,2,2,8
13819,301,3,1140.35,1,3,4,8
13821,144,2,385.64,2,2,2,6
13822,5,2,632.0,5,2,3,10
13823,18,2,957.66,4,2,4,10
13824,32,5,1698.94,4,4,4,12
13826,176,1,189.5,2,1,1,4
13827,57,3,412.05,3,3,2,8
13828,22,1,209.49,4,1,1,6
13831,16,6,2202.99,4,5,5,14
13832,19,1,52.199999999999996,4,1,1,6
13833,159,1,384.8,2,1,2,5
13835,25,4,834.57,4,4,3,11
13837,211,2,271.24,1,2,2,5
13838,5,4,691.73,5,4,3,12
13841,252,1,85.0,1,1,1,3
13842,58,9,3385.62,3,5,5,13
13844,11,1,361.62,5,1,2,8
13845,64,1,312.98,3,1,2,6
13846,24,3,865.0600000000001,4,3,3,10
13848,92,3,1255.0,2,3,4,9
13849,51,2,1537.95,3,2,4,9
13850,129,1,1595.48,2,1,4,7
13851,95,3,2651.46,2,3,5,10
13853,57,1,1090.14,3,1,4,8
13854,8,25,8109.5199999999995,5,5,5,15
13856,168,3,388.5,2,3,2,7
13858,57,1,216.17,3,1,1,5
13859,326,1,201.16,1,1,1,3
13860,1,5,1245.9,5,4,4,13
13862,18,8,2209.36,4,5,5,14
13863,247,1,305.78,1,1,2,4
13865,58,4,501.56,3,4,3,10
13866,74,1,145.67000000000002,2,1,1,4
13867,31,3,1015.29,4,3,4,11
13868,7,2,3192.54,5,2,5,12
13869,123,4,3104.95,2,4,5,11
13870,2,8,2770.94,5,5,5,15
13871,22,13,6403.25,4,5,5,14
13873,119,3,389.6,2,3,2,7
13874,358,1,540.45,1,1,3,5
13875,53,5,1786.79,3,4,4,11
13876,63,1,122.7,3,1,1,5
13877,86,1,117.24,2,1,1,4
13878,54,1,1281.53,3,1,4,8
13880,21,13,3219.77,4,5,5,14
13881,3,20,17159.52,5,5,5,15
13882,2,5,1191.13,5,4,4,13
13883,10,5,2674.48,5,4,5,14
13884,7,5,787.6,5,4,3,12
13885,189,2,506.8,1,2,3,6
13886,71,1,243.56,3,1,1,5
13887,204,1,349.55,1,1,2,4
13888,119,2,605.63,2,2,3,7
13889,92,1,416.90000000000003,2,1,2,5
13890,1,10,1883.8100000000002,5,5,4,14
13892,26,4,632.97,4,4,3,11
13893,297,1,821.1,1,1,3,5
13894,23,3,564.62,4,3,3,10
13895,28,4,2593.07,4,4,5,13
13897,50,1,311.16,3,1,2,6
13898,325,1,155.93,1,1,1,3
13899,16,2,388.52,4,2,2,8
13900,183,3,740.95,1,3,3,7
13901,72,5,2867.2,2,4,5,11
13904,37,2,332.64,3,2,2,7
13908,79,4,2369.55,2,4,5,11
13911,57,9,2580.91,3,5,5,13
13914,11,2,626.45,5,2,3,10
13917,49,2,272.04,3,2,2,7
13918,49,2,1212.8400000000001,3,2,4,9
13919,59,2,384.81,3,2,2,7
13922,351,1,172.25,1,1,1,3
13923,53,1,351.13,3,1,2,6
13924,1,6,1838.8500000000001,5,5,4,14
13925,92,4,678.25,2,4,3,9
13926,23,1,223.85000000000002,4,1,1,6
13927,74,1,348.99,2,1,2,5
13928,10,4,464.57,5,4,2,11
13929,169,2,842.65,2,2,3,7
13930,57,2,337.34,3,2,2,7
13931,95,2,1237.53,2,2,4,8
13932,294,1,307.4,1,1,2,4
13933,109,2,608.7900000000001,2,2,3,7
13934,263,1,922.1,1,1,3,5
13936,179,1,376.58,2,1,2,5
13937,169,1,158.85,2,1,1,4
13938,35,1,71.66,3,1,1,5
13939,23,3,568.55,4,3,3,10
13940,17,4,839.14,4,4,3,11
13941,21,5,5112.96,4,4,5,13
13946,79,3,561.5699999999999,2,3,3,8
13947,65,1,90.6,3,1,1,5
13948,360,1,102.0,1,1,1,3
13949,2,6,2427.32,5,5,5,15
13950,11,4,745.06,5,4,3,12
13951,176,3,674.45,2,3,3,8
13952,217,2,3251.071,1,2,5,8
13953,7,7,3515.68,5,5,5,15
13954,1,2,439.92,5,3,2,10
13955,154,2,322.96,2,3,2,7
13956,5,5,1026.42,5,4,4,13
13959,79,3,598.2,2,3,3,8
13960,21,2,230.22,4,3,1,8
13962,21,2,169.55,4,3,1,8
13963,308,4,664.54,1,4,3,8
13967,145,1,80.7,2,1,1,4
13969,7,18,9053.94,5,5,5,15
13971,18,8,2758.26,4,5,5,14
13972,70,2,190.25,3,3,1,7
13973,287,1,264.7,1,1,2,4
13974,49,1,413.59000000000003,3,1,2,6
13975,31,6,2526.28,4,5,5,14
13976,206,1,357.98,1,1,2,4
13978,14,2,196.79000000000002,4,3,1,8
13979,73,1,869.87,2,1,3,6
13980,60,1,200.14,3,1,1,5
13982,39,4,1871.81,3,4,4,11
13983,29,12,2603.43,4,5,5,14
13984,26,5,920.51,4,4,3,11
13985,4,15,7060.13,5,5,5,15
13986,17,1,320.46,4,1,2,7
13988,19,6,4147.96,4,5,5,14
13989,65,2,1266.08,3,3,4,10
13990,213,1,311.3,1,1,2,4
13991,12,6,855.97,5,5,3,13
13992,30,1,76.8,4,1,1,6
13993,42,9,3466.36,3,5,5,13
13994,3,6,2313.14,5,5,5,15
13995,15,5,1393.69,4,4,4,12
13999,10,12,3901.81,5,5,5,15
14000,211,1,635.66,1,1,3,5
14001,45,3,2043.0800000000002,3,3,4,10
14002,134,2,529.73,2,3,3,8
14004,43,7,4582.64,3,5,5,13
14005,9,5,2874.72,5,4,5,14
14006,115,3,962.19,2,3,4,9
14009,198,2,695.61,1,3,3,7
14012,277,1,328.8,1,1,2,4
14013,110,3,473.02,2,3,2,7
14014,77,1,505.18,2,1,3,6
14015,52,1,917.34,3,1,3,7
14016,161,4,4341.21,2,4,5,11
14019,46,3,1421.61,3,3,4,10
14020,16,2,642.8,4,3,3,10
14021,155,3,631.9,2,3,3,8
14022,225,1,440.0,1,1,2,4
14023,7,2,584.07,5,3,3,11
14024,121,2,327.7,2,3,2,7
14027,60,1,104.82,3,1,1,5
14029,63,2,467.66,3,3,2,8
14030,18,8,2360.09,4,5,5,14
14031,7,19,17286.86,5,5,5,15
14032,2,11,2975.59,5,5,5,15
14034,22,3,651.8199999999999,4,3,3,10
14035,28,5,1428.02,4,4,4,12
14036,284,1,626.65,1,1,3,5
14037,176,2,147.20000000000002,2,3,1,6
14038,78,3,1560.38,2,3,4,9
14039,33,1,152.2,3,1,1,5
14040,40,12,3614.92,3,5,5,13
14041,266,1,141.41,1,1,1,3
14044,26,4,652.82,4,4,3,11
14045,109,4,1659.75,2,4,4,10
14046,284,1,154.99,1,1,1,3
14047,8,5,1308.6100000000001,5,4,4,13
14048,305,1,409.93,1,1,2,4
14049,16,4,5681.72,4,4,5,13
14050,31,2,746.36,4,3,3,10
14051,0,23,15610.390000000001,5,5,5,15
14052,19,1,225.36,4,1,1,6
14053,124,2,260.25,2,3,2,7
14054,65,1,92.46,3,1,1,5
14055,106,1,725.6400000000001,2,1,3,6
14056,1,23,8214.65,5,5,5,15
14057,23,17,6217.96,4,5,5,14
14059,266,1,183.6,1,1,1,3
14060,4,19,6140.42,5,5,5,15
14062,9,12,10464.85,5,5,5,15
14064,29,5,1353.74,4,4,4,12
14066,266,1,152.55,1,1,1,3
14067,63,2,374.7,3,3,2,8
14068,320,1,265.85,1,1,2,4
14071,3,8,1438.82,5,5,4,14
14073,32,1,151.04,4,1,1,6
14075,4,3,942.26,5,3,4,12
14076,129,1,122.47,2,1,1,4
14077,40,5,499.41999999999996,3,4,3,10
14078,101,6,1049.37,2,5,4,11
14079,124,1,375.1,2,1,2,5
14080,32,1,45.599999999999994,4,1,1,6
14081,302,2,934.52,1,3,3,7
14082,364,1,182.25,1,1,1,3
14083,4,9,1018.43,5,5,4,14
14085,2,18,4448.54,5,5,5,15
14087,2,1,194.42,5,1,1,7
14088,10,13,50491.81,5,5,5,15
14089,56,1,161.0,3,1,1,5
14090,324,1,76.32000000000001,1,1,1,3
14092,7,14,4076.91,5,5,5,15
14093,12,1,442.85,5,1,2,8
14096,4,17,65164.79,5,5,5,15
14098,36,1,147.35,3,1,1,5
14099,16,11,3104.17,4,5,5,14
14100,137,1,194.9,2,1,1,4
14101,73,6,5976.79,2,5,5,12
14102,5,5,1360.28,5,4,4,13
14104,154,2,216.20999999999998,2,3,1,6
14105,239,1,1266.23,1,1,4,6
14107,51,7,2703.23,3,5,5,13
14108,30,2,597.91,4,3,3,10
14109,72,1,144.2,2,1,1,4
14110,3,12,5683.15,5,5,5,15
14111,14,4,692.85,4,4,3,11
14112,22,7,2915.15,4,5,5,14
14113,3,4,1840.42,5,4,4,13
14114,273,2,386.53,1,3,2,6
14116,19,5,1382.74,4,4,4,12
14117,143,1,90.0,2,1,1,4
14121,3,4,2780.15,5,4,5,14
14124,84,1,419.58000000000004,2,1,2,5
14125,10,3,2740.43,5,3,5,13
14126,7,3,706.1300000000001,5,3,3,11
14127,122,3,709.71,2,3,3,8
14128,60,2,637.5,3,3,3,9
14129,1,5,1123.8600000000001,5,4,4,13
14130,319,1,483.86,1,1,2,4
14132,2,11,3586.0299999999997,5,5,5,15
14133,129,3,605.64,2,3,3,8
14135,1,15,4690.31,5,5,5,15
14138,1,2,982.3800000000001,5,3,4,12
14139,46,1,415.82,3,1,2,6
14140,3,2,935.05,5,3,3,11
14141,2,4,915.13,5,4,3,12
14142,373,1,311.81,1,1,2,4
14143,133,1,115.8,2,1,1,4
14145,46,4,3742.2,3,4,5,12
14146,8,5,4191.0,5,4,5,14
14147,78,2,483.4,2,3,2,7
14148,233,1,157.2,1,1,1,3
14149,220,1,446.62,1,1,2,4
14150,35,2,658.64,3,3,3,9
14152,75,2,621.29,2,3,3,8
14154,239,2,1345.62,1,3,4,8
14155,266,1,118.75,1,1,1,3
14156,9,55,117379.63,5,5,5,15
14157,19,2,432.88,4,3,2,9
14158,40,1,507.66,3,1,3,7
14159,19,11,4693.01,4,5,5,14
14161,215,3,1110.52,1,3,4,8
14162,173,2,289.36,2,3,2,7
14163,87,4,2445.91,2,4,5,11
14164,70,2,1631.77,3,3,4,10
14165,275,1,122.53999999999999,1,1,1,3
14167,39,4,574.84,3,4,3,10
14171,98,1,363.79,2,1,2,5
14173,10,4,450.84,5,4,2,11
14174,33,1,134.46,3,1,1,5
14175,59,3,3222.3,3,3,5,11
14176,297,4,576.9000000000001,1,4,3,8
14177,86,4,559.41,2,4,3,9
14178,8,7,1620.93,5,5,4,14
14179,40,2,719.78,3,3,3,9
14180,10,25,4748.52,5,5,5,15
14184,66,1,452.89,3,1,2,6
14185,331,1,197.65,1,1,1,3
14188,30,6,2054.36,4,5,4,13
14189,2,15,4654.08,5,5,5,15
14191,1,13,4684.76,5,5,5,15
14193,67,2,853.39,3,3,3,9
14194,4,21,11349.52,5,5,5,15
14195,201,2,1012.0,1,3,4,8
14196,106,1,335.52,2,1,2,5
14198,18,4,701.4,4,4,3,11
14199,218,1,185.39999999999998,1,1,1,3
14201,60,7,747.44,3,5,3,11
14204,2,1,161.03,5,1,1,7
14205,16,2,466.7,4,3,2,9
14206,239,1,328.15999999999997,1,1,2,4
14208,94,1,151.74,2,1,1,4
14209,10,6,2073.43,5,5,5,15
14210,105,6,1905.8400000000001,2,5,4,11
14211,53,9,2241.1,3,5,5,13
14212,89,1,1070.48,2,1,4,7
14214,30,5,1004.38,4,4,4,12
14215,11,6,1789.72,5,5,4,14
14216,3,4,1839.3,5,4,4,13
14217,1,17,2004.98,5,5,4,14
14218,42,1,169.48000000000002,3,1,1,5
14219,4,1,89.94,5,1,1,7
14220,247,2,632.4,1,3,3,7
14221,42,9,3432.8,3,5,5,13
14222,177,1,683.17,2,1,3,6
14223,92,3,991.13,2,3,4,9
14224,110,4,1050.12,2,4,4,10
14226,28,5,2232.19,4,4,5,13
14227,26,10,3350.96,4,5,5,14
14229,51,3,1547.2,3,3,4,10
14231,183,3,925.71,1,3,3,7
14232,42,5,2048.07,3,4,4,11
14233,49,4,1462.72,3,4,4,11
14234,22,4,775.46,4,4,3,11
14235,75,5,3144.86,2,4,5,11
14236,80,2,490.86,2,3,3,8
14237,373,1,161.0,1,1,1,3
14238,326,1,146.85,1,1,1,3
14239,43,11,2380.85,3,5,5,13
14240,30,2,890.34,4,3,3,10
14241,183,1,213.70000000000002,1,1,1,3
14242,234,2,280.55,1,3,2,6
14243,8,10,2588.77,5,5,5,15
14245,219,2,1693.45,1,3,4,8
14246,110,3,1474.06,2,3,4,9
14247,278,1,136.76999999999998,1,1,1,3
14248,318,1,302.58,1,1,2,4
14250,7,3,1904.05,5,3,4,12
14251,1,5,2879.7000000000003,5,4,5,14
14256,260,2,969.0600000000001,1,3,4,8
14257,64,5,3099.7200000000003,3,4,5,12
14258,9,9,12669.98,5,5,5,15
14259,141,1,120.0,2,1,1,4
14261,50,2,1163.45,3,3,4,10
14262,8,8,2618.23,5,5,5,15
14264,154,2,333.97,2,3,2,7
14265,109,2,530.18,2,3,3,8
14267,162,3,1516.24,2,3,4,9
14270,331,1,492.65000000000003,1,1,3,5
14271,225,1,112.32,1,1,1,3
14272,73,2,437.96,2,3,2,7
14273,51,4,559.97,3,4,3,10
14276,98,3,1119.74,2,3,4,9
14277,15,3,4216.2,4,3,5,12
14280,196,1,134.04,1,1,1,3
14282,3,15,3729.34,5,5,5,15
14284,30,2,595.25,4,3,3,10
14285,21,4,1910.01,4,4,4,12
14286,23,3,4628.75,4,3,5,12
14287,8,3,176.63,5,3,1,9
14288,213,1,426.6,1,1,2,4
14289,8,6,911.26,5,5,3,13
14290,11,5,2314.65,5,4,5,14
14291,1,11,3883.25,5,5,5,15
14292,7,9,4871.93,5,5,5,15
14293,3,4,1046.56,5,4,4,13
14295,40,1,166.20000000000002,3,1,1,5
14297,17,4,1305.33,4,4,4,12
14298,8,44,51527.3,5,5,5,15
14299,8,9,3965.62,5,5,5,15
14300,18,1,43.2,4,1,1,6
14301,117,1,640.14,2,1,3,6
14304,222,1,383.45,1,1,2,4
14305,71,3,1858.96,3,3,4,10
14306,51,2,2093.32,3,3,5,11
14307,88,6,2995.72,2,5,5,12
14309,8,9,2352.53,5,5,5,15
14311,242,1,310.26,1,1,2,4
14312,46,6,1611.59,3,5,4,12
14314,106,1,120.0,2,1,1,4
14315,44,6,2481.13,3,5,5,13
14317,64,1,508.58000000000004,3,1,3,7
14320,206,2,477.79,1,3,2,6
14321,10,5,1530.75,5,4,4,13
14323,114,2,605.0600000000001,2,3,3,8
14326,242,1,183.85,1,1,1,3
14327,163,1,311.65,2,1,2,5
14329,17,7,5014.84,4,5,5,14
14331,124,2,462.65999999999997,2,3,2,7
14332,22,3,866.31,4,3,3,10
14333,67,1,415.2,3,1,2,6
14334,16,8,2552.21,4,5,5,14
14335,16,2,468.26,4,3,2,9
14336,16,4,1614.91,4,4,4,12
14338,161,2,588.22,2,3,3,8
14339,242,1,309.52,1,1,2,4
14340,218,1,134.7,1,1,1,3
14341,45,8,2182.28,3,5,5,13
14342,21,4,668.5600000000001,4,4,3,11
14344,127,8,889.9300000000001,2,5,3,10
14345,38,1,108.97999999999999,3,1,1,5
14346,120,2,1021.58,2,3,4,9
14348,260,1,409.57,1,1,2,4
14349,10,1,133.5,5,1,1,7
14350,274,1,282.93,1,1,2,4
14351,164,1,51.0,2,1,1,4
14352,157,4,1078.96,2,4,4,10
14353,215,1,90.6,1,1,1,3
14354,5,2,163.62,5,3,1,9
14355,365,1,174.4,1,1,1,3
14356,79,2,701.23,2,3,3,8
14357,43,1,225.77,3,1,1,5
14359,19,3,912.18,4,3,3,10
14360,31,4,2128.23,4,4,5,13
14362,22,1,161.2,4,1,1,6
14364,108,8,3717.35,2,5,5,12
14367,8,16,9261.52,5,5,5,15
14368,319,1,155.0,1,1,1,3
14371,295,1,100.5,1,1,1,3
14373,358,1,76.55,1,1,1,3
14375,185,1,257.68,1,1,2,4
14377,191,2,617.05,1,3,3,7
14379,44,2,348.1,3,3,2,8
14381,52,1,202.68,3,1,1,5
14382,26,1,626.0699999999999,4,1,3,8
14383,38,3,1247.69,3,3,4,10
14385,9,3,202.11,5,3,1,9
14386,296,1,142.4,1,1,1,3
14387,32,3,1770.56,4,3,4,11
14388,10,8,3212.84,5,5,5,15
14389,65,2,1043.46,3,3,4,10
14390,10,9,4652.82,5,5,5,15
14393,218,1,67.95,1,1,1,3
14395,2,9,3507.71,5,5,5,15
14396,65,2,487.99,3,3,2,8
14397,2,19,2612.96,5,5,5,15
14400,149,1,574.7,2,1,3,6
14401,4,13,4051.48,5,5,5,15
14403,130,4,1475.81,2,4,4,10
14404,33,6,1474.32,3,5,4,12
14406,119,1,156.75,2,1,1,4
14407,107,6,2157.73,2,5,5,12
14408,10,7,2606.53,5,5,5,15
14409,71,6,2059.4500000000003,3,5,5,13
14410,92,9,1105.07,2,5,4,11
14411,310,1,1063.0,1,1,4,6
14412,42,2,770.03,3,3,3,9
14413,362,1,122.7,1,1,1,3
14414,91,7,1496.98,2,5,4,11
14415,1,13,5900.28,5,5,5,15
14416,22,2,490.22,4,3,3,10
14418,3,3,1937.25,5,3,4,12
14419,10,6,1058.06,5,5,4,14
14420,99,1,387.52,2,1,2,5
14421,57,2,813.11,3,3,3,9
14422,0,6,4263.64,5,5,5,15
14423,218,1,265.2,1,1,2,4
14424,17,1,322.08,4,1,2,7
14426,23,10,4481.67,4,5,5,14
14427,50,2,363.34000000000003,3,3,2,8
14428,7,5,1244.83,5,4,4,13
14431,302,1,470.36,1,1,2,4
14432,9,6,2255.51,5,5,5,15
14434,21,6,1372.8,4,5,4,13
14436,98,1,89.06,2,1,1,4
14437,365,1,63.0,1,1,1,3
14438,306,1,131.9,1,1,1,3
14439,319,1,2661.24,1,1,5,7
14440,8,5,2357.6800000000003,5,4,5,14
14441,0,4,1712.89,5,4,4,13
14442,204,2,1589.82,1,3,4,8
14443,53,4,1420.2,3,4,4,11
14446,0,4,1039.58,5,4,4,13
14447,18,5,1163.23,4,4,4,12
14448,9,2,375.35,5,3,2,10
14449,18,4,907.1,4,4,3,11
14450,180,3,483.25,1,3,2,6
14451,60,2,662.59,3,3,3,9
14452,10,2,264.44,5,3,2,10
14453,190,1,119.93,1,1,1,3
14456,5,9,3062.4,5,5,5,15
14457,310,1,113.64,1,1,1,3
14459,155,1,1837.92,2,1,4,7
14460,110,3,434.34,2,3,2,7
14461,148,3,2103.06,2,3,5,10
14462,66,11,2004.02,3,5,4,12
14463,98,3,529.62,2,3,3,8
14465,246,3,1058.6200000000001,1,3,4,8
14466,29,7,2272.4,4,5,5,14
14467,17,4,598.76,4,4,3,11
14470,11,2,461.19,5,3,2,10
14472,103,8,1936.84,2,5,4,11
14473,74,2,234.34000000000003,2,3,1,6
14474,46,1,547.66,3,1,3,7
14475,71,3,925.85,3,3,3,9
14476,257,1,215.7,1,1,1,3
14477,19,4,1309.6,4,4,4,12
14479,253,2,316.25,1,3,2,6
14480,11,1,279.05,5,1,2,8
14481,164,2,636.51,2,3,3,8
14482,18,6,2068.15,4,5,5,14
14483,281,1,137.1,1,1,1,3
14484,50,1,321.92,3,1,2,6
14485,38,1,165.75,3,1,1,5
14487,26,6,1196.33,4,5,4,13
14488,67,1,1064.28,3,1,4,8
14489,207,1,463.38,1,1,2,4
14491,175,2,340.93,2,3,2,7
14493,7,5,2383.2400000000002,5,4,5,14
14494,25,1,139.56,4,1,1,6
14495,50,2,123.8,3,3,1,7
14496,311,2,538.8100000000001,1,3,3,7
14497,309,1,475.37,1,1,2,4
14498,42,5,1957.32,3,4,4,11
14499,26,3,815.32,4,3,3,10
14500,88,3,356.85,2,3,2,7
14501,183,2,251.21,1,3,2,6
14502,19,11,2470.67,4,5,5,14
14503,3,6,3543.26,5,5,5,15
14504,47,4,673.26,3,4,3,10
14505,17,8,5905.64,4,5,5,14
14506,17,5,2012.17,4,4,4,12
14507,23,6,1383.18,4,5,4,13
14508,22,2,276.42,4,3,2,9
14511,11,5,1314.81,5,4,4,13
14512,187,2,275.28,1,3,2,6
14513,100,3,455.59000000000003,2,3,2,7
14514,61,3,1055.35,3,3,4,10
14515,17,6,2102.09,4,5,5,14
14517,33,2,330.45,3,3,2,8
14518,64,1,174.37,3,1,1,5
14520,1,2,270.6,5,3,2,10
14522,24,4,974.54,4,4,4,12
14523,108,1,241.09,2,1,1,4
14524,31,9,1867.68,4,5,4,13
14525,19,9,4332.2,4,5,5,14
14527,2,55,8508.82,5,5,5,15
14528,37,1,364.21999999999997,3,1,2,6
14529,60,3,620.04,3,3,3,9
14530,25,6,2925.91,4,5,5,14
14532,236,4,932.85,1,4,3,8
14533,24,7,1949.72,4,5,4,13
14534,2,18,4447.05,5,5,5,15
14535,60,3,2864.19,3,3,5,11
14536,259,1,171.8,1,1,1,3
14537,57,1,355.56,3,1,2,6
14538,64,2,388.25,3,3,2,8
14539,15,2,537.48,4,3,3,10
14540,9,3,996.26,5,3,4,12
14541,58,8,1461.65,3,5,4,12
14542,185,1,103.25,1,1,1,3
14543,28,16,3630.33,4,5,5,14
14544,24,2,2024.45,4,3,4,11
14546,5,5,2578.09,5,4,5,14
14547,3,8,4007.54,5,5,5,15
14548,150,2,652.8,2,3,3,8
14549,311,1,289.24,1,1,2,4
14550,10,2,765.62,5,3,3,11
14551,18,2,186.23,4,3,1,8
14552,151,1,165.07,2,1,1,4
14553,19,5,859.27,4,4,3,11
14554,10,4,2381.04,5,4,5,14
14555,57,2,324.14,3,3,2,8
14557,85,1,788.38,2,1,3,6
14560,7,22,2237.77,5,5,5,15
14561,75,3,1080.76,2,3,4,9
14562,3,18,5074.77,5,5,5,15
14565,95,4,3099.12,2,4,5,11
14566,110,1,1432.0,2,1,4,7
14567,56,2,1530.3600000000001,3,3,4,10
14569,1,1,227.39,5,1,1,7
14570,280,2,218.06,1,3,1,5
14572,3,7,2832.84,5,5,5,15
14573,179,9,1653.42,2,5,4,11
14576,372,1,35.400000000000006,1,1,1,3
14577,12,4,859.71,5,4,3,12
14578,3,1,168.63,5,1,1,7
14581,16,1,138.6,4,1,1,6
14582,40,1,114.11,3,1,1,5
14583,5,5,1052.55,5,4,4,13
14584,169,4,1042.26,2,4,4,10
14585,50,1,157.05,3,1,1,5
14586,276,1,237.36,1,1,1,3
14587,18,9,1601.14,4,5,4,13
14589,371,1,39.75,1,1,1,3
14591,15,4,1447.14,4,4,4,12
14592,35,3,570.46,3,3,3,9
14593,21,3,617.99,4,3,3,10
14594,7,2,379.83,5,3,2,10
14595,19,6,1740.6,4,5,4,13
14597,11,2,883.15,5,3,3,11
14598,44,1,221.97,3,1,1,5
14600,305,1,393.33000000000004,1,1,2,4
14601,10,1,213.96,5,1,1,7
14603,274,1,660.0,1,1,3,5
14606,1,93,12156.65,5,5,5,15
14607,15,14,16569.5,4,5,5,14
14608,4,4,1785.15,5,4,4,13
14609,72,4,601.56,2,4,3,9
14616,242,3,406.08000000000004,1,3,2,6
14618,9,3,553.44,5,3,3,11
14619,245,1,394.44,1,1,2,4
14620,205,2,412.78000000000003,1,3,2,6
14621,1,5,1788.3600000000001,5,4,4,13
14622,184,1,320.58000000000004,1,1,2,4
14623,32,5,889.25,4,4,3,11
14624,57,2,225.85,3,3,1,7
14625,196,2,899.63,1,3,3,7
14626,23,4,2791.27,4,4,5,13
14628,91,2,671.96,2,3,3,8
14629,4,2,959.01,5,3,4,12
14631,50,3,1006.98,3,3,4,10
14632,262,1,114.56,1,1,1,3
14633,266,1,344.90000000000003,1,1,2,4
14636,36,2,609.85,3,3,3,9
14638,50,1,443.6,3,1,2,6
14639,52,6,2984.49,3,5,5,13
14640,24,6,2125.08,4,5,5,14
14641,21,1,110.46,4,1,1,6
14642,58,1,96.12,3,1,1,5
14643,170,2,693.8100000000001,2,3,3,8
14644,67,2,830.76,3,3,3,9
14645,156,2,597.09,2,3,3,8
14646,1,74,280206.02,5,5,5,15
14647,201,1,243.22,1,1,1,3
14649,4,4,1417.29,5,4,4,13
14651,67,2,654.6,3,3,3,9
14652,77,1,114.18,2,1,1,4
14653,1,7,1947.55,5,5,4,14
14655,8,4,1932.23,5,4,4,13
14656,169,2,291.05,2,3,2,7
14657,17,4,848.22,4,4,3,11
14658,5,2,247.15,5,3,1,9
14659,8,9,2529.93,5,5,5,15
14660,86,2,285.74,2,3,2,7
14661,26,1,107.95,4,1,1,6
14662,28,4,771.17,4,4,3,11
14664,19,2,637.89,4,3,3,10
14665,60,5,1835.7,3,4,4,11
14666,24,1,195.25,4,1,1,6
14667,10,25,9241.2,5,5,5,15
14669,241,3,1269.99,1,3,4,8
14670,280,2,411.53,1,3,2,6
14672,234,2,765.55,1,3,3,7
14673,3,5,1736.4,5,4,4,13
14675,16,1,604.75,4,1,3,8
14676,31,6,2548.2400000000002,4,5,5,14
14680,25,16,28754.11,4,5,5,14
14681,71,3,498.95,3,3,3,9
14682,187,2,52.0,1,3,1,5
14684,25,5,1236.28,4,4,4,12
14687,106,1,628.38,2,1,3,6
14688,7,21,5630.87,5,5,5,15
14689,208,1,112.8,1,1,1,3
14690,44,2,371.7,3,3,2,8
14691,30,5,2114.33,4,4,5,13
14692,137,4,591.55,2,4,3,9
14693,264,1,172.9,1,1,1,3
14696,4,7,2078.95,5,5,5,15
14697,218,2,188.60999999999999,1,3,1,5
14698,1,5,1250.76,5,4,4,13
14699,214,1,109.13000000000001,1,1,1,3
14700,32,3,2235.3,4,3,5,12
14701,10,9,2549.37,5,5,5,15
14702,1,17,3292.14,5,5,5,15
14703,14,1,318.17,4,1,2,7
14704,11,9,1546.91,5,5,4,14
14705,198,1,179.0,1,1,1,3
14708,2,3,1126.37,5,3,4,12
14709,15,13,4921.04,4,5,5,14
14710,14,4,606.13,4,4,3,11
14711,10,11,2868.8,5,5,5,15
14712,29,3,917.07,4,3,3,10
14713,9,11,2666.36,5,5,5,15
14714,24,1,160.19,4,1,1,6
14715,24,4,867.38,4,4,3,11
14716,43,2,329.68,3,3,2,8
14719,1,5,1602.13,5,4,4,13
14720,5,3,663.81,5,3,3,11
14722,147,1,187.92000000000002,2,1,1,4
14723,10,6,1158.3,5,5,4,14
14725,24,1,718.08,4,1,3,8
14727,274,1,268.58,1,1,2,4
14729,373,1,313.49,1,1,2,4
14730,1,8,2005.06,5,5,4,14
14731,47,3,380.02,3,3,2,8
14732,8,8,2702.4900000000002,5,5,5,15
14733,16,12,9585.91,4,5,5,14
14735,3,32,6065.69,5,5,5,15
14737,3,3,1164.55,5,3,4,12
14738,42,7,1314.45,3,5,4,12
14739,4,7,3902.28,5,5,5,15
14740,197,3,1448.21,1,3,4,8
14741,11,6,1400.34,5,5,4,14
14744,16,7,1099.98,4,5,4,13
14745,112,5,1220.26,2,4,4,10
14747,249,1,328.2,1,1,2,4
14748,29,5,1415.75,4,4,4,12
14752,43,1,389.64,3,1,2,6
14753,87,1,563.15,2,1,3,6
14754,44,2,638.05,3,3,3,9
14755,9,11,5010.28,5,5,5,15
14756,15,1,738.96,4,1,3,8
14757,75,1,420.5,2,1,2,5
14758,144,4,1484.06,2,4,4,10
14759,4,3,1625.97,5,3,4,12
14760,297,1,89.2,1,1,1,3
14761,58,2,255.9,3,3,2,8
14762,263,1,300.52,1,1,2,4
14764,46,1,278.3,3,1,2,6
14765,29,3,254.11,4,3,2,9
14766,8,6,2473.37,5,5,5,15
14768,17,2,192.60000000000002,4,3,1,8
14769,2,8,10674.75,5,5,5,15
14770,232,2,876.42,1,3,3,7
14772,112,1,139.26,2,1,1,4
14775,58,3,1011.9,3,3,4,10
14776,51,11,2538.3,3,5,5,13
14778,127,2,730.86,2,3,3,8
14779,280,3,386.15,1,3,2,6
14780,54,2,447.68,3,3,2,8
14782,319,1,200.10000000000002,1,1,1,3
14784,26,2,289.99,4,3,2,9
14785,10,2,77.4,5,3,1,9
14788,7,2,679.4399999999999,5,3,3,11
14789,28,1,197.64,4,1,1,6
14790,16,4,745.06,4,4,3,11
14792,63,1,6.2,3,1,1,5
14793,21,1,228.99,4,1,1,6
14794,2,7,1319.91,5,5,4,14
14795,166,1,131.45000000000002,2,1,1,4
14796,1,17,8022.49,5,5,5,15
14798,52,3,173.74,3,3,1,7
14799,51,1,157.7,3,1,1,5
14800,47,12,4339.74,3,5,5,13
14801,61,1,193.14,3,1,1,5
14803,162,3,845.55,2,3,3,8
14804,8,1,353.27,5,1,2,8
14805,15,4,554.65,4,4,3,11
14806,75,1,193.39000000000001,2,1,1,4
14808,39,8,2741.17,3,5,5,13
14810,40,11,2087.88,3,5,5,13
14813,369,2,155.43,1,3,1,5
14815,36,2,778.5,3,3,3,9
14816,197,1,271.85,1,1,2,4
14817,200,2,1110.34,1,3,4,8
14818,73,3,657.8,2,3,3,8
14819,64,2,272.07,3,3,2,8
14820,21,4,507.29,4,4,3,11
14821,366,1,48.800000000000004,1,1,1,3
14823,180,3,321.43,1,3,2,6
14824,10,4,1127.71,5,4,4,13
14825,3,12,2226.91,5,5,5,15
14828,196,3,2139.76,1,3,5,9
14829,29,4,697.55,4,4,3,11
14830,53,1,197.13,3,1,1,5
14834,17,6,1720.3,4,5,4,13
14836,10,3,102.44999999999999,5,3,1,9
14837,89,4,1649.5,2,4,4,10
14840,267,1,62.85,1,1,1,3
14841,53,6,3295.76,3,5,5,13
14842,43,4,2824.69,3,4,5,12
14844,63,4,3189.81,3,4,5,12
14847,148,1,309.4,2,1,2,5
14849,21,25,7930.54,4,5,5,14
14850,311,1,325.75,1,1,2,4
14851,23,2,511.35,4,3,3,10
14852,58,6,2836.69,3,5,5,13
14853,24,2,475.8,4,3,2,9
14854,78,7,2759.83,2,5,5,12
14855,119,2,645.65,2,3,3,8
14856,36,3,1311.3799999999999,3,3,4,10
14857,59,2,1173.12,3,3,4,10
14859,12,4,1353.74,5,4,4,13
14860,19,1,170.32,4,1,1,6
14861,52,1,125.79,3,1,1,5
14862,25,2,841.1999999999999,4,3,3,10
14863,29,1,266.76,4,1,2,7
14865,7,2,52.2,5,3,1,9
14866,10,12,14389.9,5,5,5,15
14867,185,3,710.28,1,3,3,7
14868,3,8,2953.59,5,5,5,15
14869,8,2,725.7,5,3,3,11
14870,261,1,327.25,1,1,2,4
14871,3,4,522.38,5,4,3,12
14873,210,1,519.68,1,1,3,5
14875,107,2,1465.3200000000002,2,3,4,9
14878,12,9,1485.54,5,5,4,14
14880,77,3,706.19,2,3,3,8
14881,19,1,255.4,4,1,2,7
14882,26,2,589.7,4,3,3,10
14883,18,6,761.59,4,5,3,12
14885,131,1,765.3199999999999,2,1,3,6
14886,252,1,364.8,1,1,2,4
14887,79,1,1862.0,2,1,4,7
14888,207,1,369.2,1,1,2,4
14889,336,1,135.9,1,1,1,3
14890,253,1,125.65,1,1,1,3
14891,148,2,554.38,2,3,3,8
14893,9,2,1237.8500000000001,5,3,4,12
14894,85,1,655.75,2,1,3,6
14895,7,20,11138.710000000001,5,5,5,15
14896,204,2,468.77000000000004,1,3,2,6
14897,7,4,1366.38,5,4,4,13
14898,23,6,1303.52,4,5,4,13
14901,11,9,1421.29,5,5,4,14
14902,25,1,332.66,4,1,2,7
14903,21,5,2810.63,4,4,5,13
14904,2,2,1025.44,5,3,4,12
14905,157,2,616.15,2,3,3,8
14907,3,7,3501.1,5,5,5,15
14908,74,1,277.8,2,1,2,5
14910,2,4,434.35,5,4,2,11
14911,1,201,143825.06,5,5,5,15
14912,16,2,867.85,4,3,3,10
14913,35,4,1227.43,3,4,4,11
14915,91,2,307.48,2,3,2,7
14916,70,4,1268.98,3,4,4,11
14918,115,2,1610.15,2,3,4,9
14920,212,2,977.77,1,3,4,8
14921,30,2,1316.07,4,3,4,11
14923,50,1,749.1,3,1,3,7
14924,245,1,310.05,1,1,2,4
14929,32,1,223.88,4,1,1,6
14930,108,3,2372.86,2,3,5,10
14931,4,5,1257.68,5,4,4,13
14932,365,1,363.53,1,1,2,4
14934,81,2,1890.94,2,3,4,9
14935,297,1,1784.71,1,1,4,6
14936,33,8,8137.02,3,5,5,13
14937,56,3,1621.88,3,3,4,10
14944,29,12,5900.25,4,5,5,14
14946,14,1,100.9,4,1,1,6
14947,72,2,290.82,2,3,2,7
14948,23,6,1101.97,4,5,4,13
14950,19,1,371.2,4,1,2,7
14951,79,1,311.69,2,1,2,5
14952,59,11,8099.49,3,5,5,13
14953,25,1,289.82,4,1,2,7
14954,12,1,336.17,5,1,2,8
14957,253,1,58.49,1,1,1,3
14958,147,3,499.68,2,3,3,8
14959,64,4,695.42,3,4,3,10
14960,8,2,221.27,5,3,1,9
14961,10,9,7044.68,5,5,5,15
14962,270,1,126.7,1,1,1,3
14963,9,5,1487.8,5,4,4,13
14964,247,1,206.21,1,1,1,3
14965,96,2,599.0,2,3,3,8
14966,14,1,191.32,4,1,1,6
14967,49,1,463.8,3,1,2,6
14968,30,1,147.59,4,1,1,6
14970,68,4,1592.06,3,4,4,11
14971,35,3,1116.57,3,3,4,10
14972,128,1,114.77,2,1,1,4
14973,107,3,1314.45,2,3,4,9
14974,37,1,114.39,3,1,1,5
14975,57,1,279.94,3,1,2,6
14976,57,7,790.86,3,5,3,11
14978,72,5,1931.42,2,4,4,10
14981,246,1,102.12,1,1,1,3
14984,19,2,213.27,4,3,1,8
14985,198,2,296.75,1,3,2,6
14987,15,2,326.4,4,3,2,9
14988,211,1,334.54,1,1,2,4
14995,38,2,233.23000000000002,3,3,1,7
14997,46,3,546.1999999999999,3,3,3,9
14998,170,2,429.87,2,3,2,7
15000,47,1,490.52,3,1,3,7
15002,115,4,1641.76,2,4,4,10
15004,147,1,1246.32,2,1,4,7
15005,15,28,6316.57,4,5,5,14
15006,51,1,502.09,3,1,3,7
15007,159,1,156.91,2,1,1,4
15009,12,3,1261.78,5,3,4,12
15010,35,1,308.94,3,1,2,6
15012,53,2,423.04,3,3,2,8
15014,43,2,260.17,3,3,2,8
15016,172,1,170.04,2,1,1,4
15017,33,1,125.58,3,1,1,5
15018,38,3,496.21000000000004,3,3,3,9
15019,266,1,266.0,1,1,2,4
15021,8,9,1914.82,5,5,4,14
15022,11,4,905.04,5,4,3,12
15023,3,11,6802.76,5,5,5,15
15024,9,10,1661.33,5,5,4,14
15025,33,1,377.01,3,1,2,6
15026,80,3,469.0,2,3,2,7
15027,30,4,1066.1499999999999,4,4,4,12
15028,8,4,627.13,5,4,3,12
15030,71,2,518.28,3,3,3,9
15031,4,4,668.14,5,4,3,12
15032,256,3,4959.1,1,3,5,9
15033,4,10,2586.67,5,5,5,15
15034,15,8,4308.61,4,5,5,14
15035,89,1,252.73000000000002,2,1,2,5
15036,72,3,465.55,2,3,2,7
15038,58,6,705.49,3,5,3,11
15039,9,47,19914.44,5,5,5,15
15041,170,1,180.35,2,1,1,4
15042,199,1,135.93,1,1,1,3
15043,31,1,537.0,4,1,3,8
15044,19,17,7700.2300000000005,4,5,5,14
15045,151,2,735.66,2,3,3,8
15046,9,15,5213.7699999999995,5,5,5,15
15047,269,1,343.62,1,1,2,4
15048,65,4,384.05,3,4,2,9
15049,273,1,121.17000000000002,1,1,1,3
15050,25,3,1782.09,4,3,4,11
15051,23,3,1391.61,4,3,4,11
15052,319,1,215.78,1,1,1,3
15053,4,3,697.79,5,3,3,11
15054,12,2,302.1,5,3,2,10
15057,275,2,1489.5,1,3,4,8
15058,25,11,2124.9900000000002,4,5,5,14
15059,40,9,1337.72,3,5,4,12
15060,8,4,303.09,5,4,2,11
15061,3,48,54534.14,5,5,5,15
15062,71,4,987.86,3,4,4,11
15063,213,1,370.79999999999995,1,1,2,4
15065,37,4,3158.13,3,4,5,12
15066,53,1,893.59,3,1,3,7
15067,78,3,1744.76,2,3,4,9
15068,46,2,553.36,3,3,3,9
15069,179,1,1109.53,2,1,4,7
15070,372,1,106.2,1,1,1,3
15071,93,2,982.07,2,3,4,9
15073,9,3,1043.41,5,3,4,12
15074,105,1,748.87,2,1,3,6
15075,77,1,773.03,2,1,3,6
15076,172,1,880.85,2,1,3,6
15078,7,32,9743.11,5,5,5,15
15079,212,4,895.61,1,4,3,8
15081,22,5,504.8,4,4,3,11
15083,256,1,88.2,1,1,1,3
15087,281,1,306.94,1,1,2,4
15088,21,2,1160.07,4,3,4,11
15089,10,6,2420.84,5,5,5,15
15090,308,1,381.32,1,1,2,4
15091,67,1,480.71,3,1,2,6
15092,215,2,457.81,1,3,2,6
15093,18,6,4597.02,4,5,5,14
15095,103,4,1370.6,2,4,4,10
15096,42,1,219.39000000000001,3,1,1,5
15097,4,1,248.08,5,1,1,7
15098,182,3,39916.5,1,3,5,9
15099,84,1,410.48,2,1,2,5
15100,333,3,876.0,1,3,3,7
15101,8,2,317.53,5,3,2,10
15103,31,2,703.36,4,3,3,10
15104,196,2,1027.44,1,3,4,8
15105,18,7,2298.93,4,5,5,14
15106,17,5,1422.52,4,4,4,12
15107,311,6,319.5,1,5,2,8
15108,141,4,1300.25,2,4,4,10
15109,245,1,484.95,1,1,2,4
15110,23,4,996.1,4,4,4,12
15111,29,3,1567.48,4,3,4,11
15113,9,3,3609.33,5,3,5,13
15114,30,10,2760.56,4,5,5,14
15115,18,1,340.11,4,1,2,7
15116,17,4,1352.75,4,4,4,12
15117,14,5,1551.78,4,4,4,12
15118,134,1,244.8,2,1,1,4
15119,245,1,266.4,1,1,2,4
15120,133,1,358.82,2,1,2,5
15121,50,2,457.72,3,3,2,8
15122,114,3,1633.78,2,3,4,9
15123,7,2,2199.31,5,3,5,13
15124,22,2,184.19,4,3,1,8
15125,25,15,11528.48,4,5,5,14
15127,65,1,406.53,3,1,2,6
15128,60,4,1471.0,3,4,4,11
15129,50,11,3447.4,3,5,5,13
15130,169,1,330.11,2,1,2,5
15132,18,5,977.9300000000001,4,4,4,12
15133,127,3,982.42,2,3,4,9
15134,14,8,1387.99,4,5,4,13
15135,239,1,139.05,1,1,1,3
15136,2,4,1286.7,5,4,4,13
15139,239,2,178.96,1,3,1,5
15140,52,7,2354.25,3,5,5,13
15142,46,1,498.74,3,1,3,7
15143,225,1,259.45,1,1,2,4
15144,8,17,6580.44,5,5,5,15
15145,4,4,1194.73,5,4,4,13
15146,164,2,1327.16,2,3,4,9
15147,240,1,623.5,1,1,3,5
15148,10,1,301.29,5,1,2,8
15149,133,1,520.8000000000001,2,1,3,6
15150,17,10,5314.47,4,5,5,14
15152,9,13,4745.69,5,5,5,15
15153,31,1,329.25,4,1,2,7
15154,75,1,296.42,2,1,2,5
15156,1,3,961.49,5,3,4,12
15157,3,3,1936.07,5,3,4,12
15158,45,1,401.40000000000003,3,1,2,6
15159,1,30,18641.010000000002,5,5,5,15
15160,357,1,158.16,1,1,1,3
15163,18,2,304.47,4,3,2,9
15164,68,3,843.05,3,3,3,9
15165,373,1,487.75,1,1,2,4
15167,320,1,163.0,1,1,1,3
15168,25,1,106.56,4,1,1,6
15171,331,1,1289.5,1,1,4,6
15172,8,5,1624.05,5,4,4,13
15174,322,1,135.75,1,1,1,3
15175,71,1,224.14,3,1,1,5
15178,260,1,40.5,1,1,1,3
15179,18,5,2206.95,4,4,5,13
15180,367,1,87.5,1,1,1,3
15181,66,3,689.4799999999999,3,3,3,9
15182,154,2,622.85,2,3,3,8
15184,29,2,406.76,4,3,2,9
15185,70,1,310.62,3,1,2,6
15186,14,2,411.41,4,3,2,9
15187,1,16,4777.18,5,5,5,15
15189,1,41,16225.39,5,5,5,15
15192,119,3,1044.32,2,3,4,9
15193,60,1,499.32,3,1,3,7
15194,3,15,7616.53,5,5,5,15
15195,2,1,3861.0,5,1,5,11
15197,10,3,1079.6100000000001,5,3,4,12
15198,92,2,193.64,2,3,1,6
15199,59,4,1268.7,3,4,4,11
15201,87,5,1236.54,2,4,4,10
15203,25,6,1827.8,4,5,4,13
15204,357,1,316.58,1,1,2,4
15205,85,2,653.24,2,3,3,8
15206,10,4,420.29999999999995,5,4,2,11
15208,1,5,870.12,5,4,3,12
15210,225,1,331.18,1,1,2,4
15211,60,2,894.4100000000001,3,3,3,9
15212,241,1,101.8,1,1,1,3
15213,318,2,328.35,1,3,2,6
15214,1,8,1661.44,5,5,4,14
15215,46,3,734.94,3,3,3,9
15216,87,1,96.6,2,1,1,4
15218,10,11,5756.89,5,5,5,15
15219,176,1,305.75,2,1,2,5
15220,51,6,1778.96,3,5,4,12
15221,366,1,403.25,1,1,2,4
15222,318,1,585.0,1,1,3,5
15223,225,2,755.75,1,3,3,7
15224,358,2,322.08,1,3,2,6
15225,234,1,409.40000000000003,1,1,2,4
15226,310,1,154.41,1,1,1,3
15227,36,5,1219.4,3,4,4,11
15228,66,4,3386.71,3,4,5,12
15230,239,2,429.6,1,3,2,6
15232,113,2,612.06,2,3,3,8
15234,276,1,197.0,1,1,1,3
15235,217,12,2247.51,1,5,5,11
15236,298,1,321.05,1,1,2,4
15237,1,4,1412.32,5,4,4,13
15238,29,3,1071.99,4,3,4,11
15239,10,2,780.59,5,3,3,11
15240,44,5,1706.57,3,4,4,11
15241,66,8,1756.44,3,5,4,12
15243,74,1,316.68,2,1,2,5
15244,65,2,631.57,3,3,3,9
15245,134,3,2515.84,2,3,5,10
15246,238,2,514.15,1,3,3,7
15247,122,1,356.0,2,1,2,5
15249,31,13,6688.46,4,5,5,14
15251,9,11,10484.99,5,5,5,15
15252,36,2,740.78,3,3,3,9
15253,16,5,918.1999999999999,4,4,3,11
15254,127,1,300.36,2,1,2,5
15255,66,1,890.85,3,1,3,7
15256,148,1,98.45,2,1,1,4
15257,283,1,317.15,1,1,2,4
15258,168,2,623.16,2,3,3,8
15260,100,7,1810.77,2,5,4,11
15261,135,1,254.82,2,1,2,5
15262,323,1,178.95000000000002,1,1,1,3
15263,106,1,156.51,2,1,1,4
15264,64,1,393.74,3,1,2,6
15265,151,2,1506.1200000000001,2,3,4,9
15266,338,1,119.3,1,1,1,3
15267,22,5,1717.36,4,4,4,12
15269,23,1,408.8,4,1,2,7
15270,15,7,2379.49,4,5,5,14
15271,7,15,2507.07,5,5,5,15
15272,57,2,721.94,3,3,3,9
15274,4,2,716.57,5,3,3,11
15275,37,1,615.14,3,1,3,7
15276,66,1,135.31,3,1,1,5
15277,46,1,255.89999999999998,3,1,2,6
15279,354,1,290.51,1,1,2,4
15280,172,1,113.12,2,1,1,4
15281,58,9,2332.15,3,5,5,13
15286,49,1,240.55,3,1,1,5
15287,22,2,486.69,4,3,2,9
15288,43,5,2306.52,3,4,5,12
15289,29,3,939.78,4,3,3,10
15290,4,18,7943.22,5,5,5,15
15291,25,15,4668.3,4,5,5,14
15292,201,1,180.94,1,1,1,3
15296,50,6,3672.86,3,5,5,13
15297,10,3,641.94,5,3,3,11
15298,2,12,4799.9,5,5,5,15
15299,67,7,4507.01,3,5,5,13
15300,64,1,496.44,3,1,3,7
15301,50,12,5070.35,3,5,5,13
15303,290,1,574.02,1,1,3,5
15304,60,8,694.4000000000001,3,5,3,11
15306,64,3,1174.35,3,3,4,10
15307,95,1,205.3,2,1,1,4
15308,274,1,310.47,1,1,2,4
15311,0,91,60767.9,5,5,5,15
15312,75,4,924.85,2,4,3,9
15313,110,1,52.0,2,1,1,4
15314,199,1,327.97,1,1,2,4
15315,64,2,570.5,3,3,3,9
15316,326,1,165.0,1,1,1,3
15318,3,1,312.62,5,1,2,8
15319,283,1,204.5,1,1,1,3
15320,44,1,267.13,3,1,2,6
15321,70,3,2748.31,3,3,5,11
15322,85,1,679.68,2,1,3,6
15325,103,1,162.29,2,1,1,4
15326,333,1,311.71,1,1,2,4
15327,52,1,208.75,3,1,1,5
15329,39,3,1049.7,3,3,4,10
15330,32,2,714.96,4,3,3,10
15332,366,4,1661.06,1,4,4,9
15333,208,1,1028.56,1,1,4,6
15334,156,3,351.67,2,3,2,7
15335,53,1,173.97,3,1,1,5
15339,66,2,574.07,3,3,3,9
15341,80,1,2020.52,2,1,4,7
15342,129,1,406.09,2,1,2,5
15343,87,1,364.5,2,1,2,5
15344,0,3,563.94,5,3,3,11
15345,45,1,393.54,3,1,2,6
15346,332,1,252.42000000000002,1,1,2,4
15347,366,1,201.60000000000002,1,1,1,3
15348,72,1,158.04,2,1,1,4
15349,158,2,473.81,2,3,2,7
15350,373,1,115.65,1,1,1,3
15351,12,7,1960.1100000000001,5,5,4,14
15353,254,2,777.02,1,3,3,7
15355,29,2,277.05,4,3,2,9
15356,31,10,2766.5,4,5,5,14
15358,4,22,8347.2,5,5,5,15
15360,39,1,427.93,3,1,2,6
15361,361,1,418.92,1,1,2,4
15363,372,1,326.0,1,1,2,4
15364,95,2,913.19,2,3,3,8
15365,25,7,2314.32,4,5,5,14
15366,75,2,602.51,2,3,3,8
15367,57,4,1877.59,3,4,4,11
15368,21,1,446.94000000000005,4,1,2,7
15370,40,7,2386.05,3,5,5,13
15372,137,1,2007.3999999999999,2,1,4,7
15373,8,12,2415.91,5,5,5,15
15374,128,1,168.0,2,1,1,4
15376,40,3,1233.3600000000001,3,3,4,10
15379,169,7,3703.29,2,5,5,12
15380,8,5,1690.2600000000002,5,4,4,13
15381,213,2,596.85,1,3,3,7
15382,14,6,5955.71,4,5,5,14
15384,169,2,642.41,2,3,3,8
15385,40,1,316.88,3,1,2,6
15386,186,1,394.14,1,1,2,4
15388,270,1,140.54,1,1,1,3
15389,172,1,500.0,2,1,3,6
15392,4,4,1535.53,5,4,4,13
15393,16,2,231.86,4,3,1,8
15394,9,4,2183.54,5,4,5,14
15395,325,1,107.45,1,1,1,3
15396,112,1,288.18,2,1,2,5
15397,289,1,94.0,1,1,1,3
15398,16,2,1345.53,4,3,4,11
15399,1,3,815.77,5,3,3,11
15400,92,5,716.2,2,4,3,9
15402,148,2,626.77,2,3,3,8
15405,189,1,349.1,1,1,2,4
15406,31,2,510.71000000000004,4,3,3,10
15407,33,4,1056.44,3,4,4,11
15408,264,1,267.18,1,1,2,4
15410,84,8,3450.84,2,5,5,12
15411,26,4,1358.88,4,4,4,12
15412,171,1,190.53,2,1,1,4
15414,9,3,774.9000000000001,5,3,3,11
15415,313,1,572.8100000000001,1,1,3,5
15416,64,4,3984.32,3,4,5,12
15417,85,1,508.8,2,1,3,6
15419,24,1,135.86,4,1,1,6
15421,58,4,950.36,3,4,4,11
15422,323,2,97.7,1,3,1,5
15423,38,1,43.5,3,1,1,5
15424,254,2,383.34,1,3,2,6
15426,19,5,1447.39,4,4,4,12
15427,33,3,1483.14,3,3,4,10
15428,15,1,93.78,4,1,1,6
15429,26,2,397.35,4,3,2,9
15432,23,1,171.19,4,1,1,6
15433,213,2,533.3,1,3,3,7
15434,8,5,1041.48,5,4,4,13
15435,22,1,149.29,4,1,1,6
15436,12,3,1122.53,5,3,4,12
15437,262,1,200.16,1,1,1,3
15438,131,1,156.57999999999998,2,1,1,4
15440,54,3,383.68,3,3,2,8
15442,248,1,594.0,1,1,3,5
15443,1,7,3236.91,5,5,5,15
15444,9,2,1418.26,5,3,4,12
15445,264,1,113.5,1,1,1,3
15447,330,1,155.17,1,1,1,3
15448,312,1,494.64,1,1,3,5
15449,26,3,974.52,4,3,4,11
15450,30,1,429.84,4,1,2,7
15452,29,3,538.73,4,3,3,10
15453,1,7,1388.37,5,5,4,14
15454,362,1,179.1,1,1,1,3
15456,283,3,447.22,1,3,2,6
15457,262,1,237.07,1,1,1,3
15458,25,1,161.64,4,1,1,6
15460,354,1,216.76,1,1,1,3
15462,94,3,234.6,2,3,1,6
15463,29,1,126.14,4,1,1,6
15464,338,1,1048.85,1,1,4,6
15465,19,18,7354.62,4,5,5,14
15466,85,1,334.53,2,1,2,5
15467,9,3,524.88,5,3,3,11
15468,51,2,467.51,3,3,2,8
15469,50,2,538.55,3,3,3,9
15471,2,1,469.48,5,1,2,8
15472,113,1,371.56,2,1,2,5
15473,14,7,1771.2,4,5,4,13
15475,77,1,454.10999999999996,2,1,2,5
15478,40,2,1441.42,3,3,4,10
15480,116,1,905.5,2,1,3,6
15482,15,12,11054.96,4,5,5,14
15483,161,4,233.81,2,4,1,7
15484,1,4,3594.31,5,4,5,14
15485,30,3,2575.0,4,3,5,12
15488,92,1,91.32000000000001,2,1,1,4
15489,22,3,1134.28,4,3,4,11
15491,95,6,3100.09,2,5,5,12
15492,28,2,659.4599999999999,4,3,3,10
15493,32,5,2001.8,4,4,4,12
15494,21,2,1299.23,4,3,4,11
15497,17,2,1262.2,4,3,4,11
15498,2,27,13316.4,5,5,5,15
15500,8,4,1131.56,5,4,4,13
15502,15,12,10384.93,4,5,5,14
15503,362,1,147.09,1,1,1,3
15504,81,1,52.83,2,1,1,4
15505,52,5,3610.96,3,4,5,12
15506,22,3,979.26,4,3,4,11
15507,171,1,492.36,2,1,3,6
15508,189,6,1000.27,1,5,4,10
15510,330,1,250.0,1,1,1,3
15511,11,5,909.23,5,4,3,12
15512,155,2,121.0,2,3,1,6
15513,33,19,14758.220000000001,3,5,5,13
15514,12,11,4139.46,5,5,5,15
15516,44,3,62.43,3,3,1,7
15517,233,1,267.03,1,1,2,4
15518,64,8,1942.45,3,5,4,12
15520,1,1,343.5,5,1,2,8
15521,40,8,3000.2,3,5,5,13
15522,32,2,398.84,4,3,2,9
15523,84,1,412.01000000000005,2,1,2,5
15524,24,1,440.0,4,1,2,7
15525,2,3,825.92,5,3,3,11
15526,33,2,148.44,3,3,1,7
15527,18,8,2429.78,4,5,5,14
15528,254,1,229.33,1,1,1,3
15529,22,11,3995.23,4,5,5,14
15530,21,4,1502.35,4,4,4,12
15531,8,2,2007.44,5,3,4,12
15532,25,4,1580.93,4,4,4,12
15533,19,3,807.57,4,3,3,10
15535,173,4,536.4,2,4,3,9
15537,163,1,110.92,2,1,1,4
15539,7,1,538.46,5,1,3,9
15540,11,1,213.3,5,1,1,7
15541,114,1,85.13000000000001,2,1,1,4
15543,288,1,127.86,1,1,1,3
15544,9,9,3546.71,5,5,5,15
15545,54,2,292.71999999999997,3,3,2,8
15547,7,14,4954.84,5,5,5,15
15549,77,3,1693.26,2,3,4,9
15550,4,4,575.63,5,4,3,12
15551,36,1,436.06,3,1,2,6
15552,217,1,90.12,1,1,1,3
15553,60,1,437.23,3,1,2,6
15554,277,1,217.2,1,1,1,3
15555,12,16,4805.17,5,5,5,15
15556,24,1,279.77,4,1,2,7
15557,28,1,473.65000000000003,4,1,2,7
15561,11,4,800.59,5,4,3,12
15562,351,1,134.55,1,1,1,3
15563,22,4,1400.44,4,4,4,12
15565,50,2,173.16,3,3,1,7
15567,18,1,186.01,4,1,1,6
15568,2,3,758.29,5,3,3,11
15569,103,5,1375.71,2,4,4,10
15570,7,12,4165.52,5,5,5,15
15571,11,4,650.4300000000001,5,4,3,12
15572,4,7,2552.86,5,5,5,15
15573,31,2,607.45,4,3,3,10
15574,177,4,702.25,2,4,3,9
15576,37,1,940.6700000000001,3,1,3,7
15577,151,3,258.88,2,3,2,7
15578,162,1,127.1,2,1,1,4
15579,68,2,348.6,3,3,2,8
15581,120,13,3679.9700000000003,2,5,5,12
15582,24,3,682.9100000000001,4,3,3,10
15584,23,4,725.11,4,4,3,11
15585,176,1,455.3,2,1,2,5
15587,50,4,913.6800000000001,3,4,3,10
15589,255,3,478.53000000000003,1,3,2,6
15592,46,1,388.58,3,1,2,6
15593,70,1,199.8,3,1,1,5
15594,15,5,1771.78,4,4,4,12
15596,100,5,1406.59,2,4,4,10
15597,35,1,324.57,3,1,2,6
15598,53,1,240.68,3,1,1,5
15599,26,2,761.74,4,3,3,10
15601,11,14,6776.56,5,5,5,15
15602,8,9,1297.8700000000001,5,5,4,14
15603,78,1,48.480000000000004,2,1,1,4
15604,52,1,216.39,3,1,1,5
15605,36,5,1198.23,3,4,4,11
15606,61,9,2920.16,3,5,5,13
15607,336,1,104.76,1,1,1,3
15608,28,4,1093.68,4,4,4,12
15609,184,1,298.48,1,1,2,4
15610,51,1,112.46000000000001,3,1,1,5
15611,9,13,1591.45,5,5,4,14
15612,36,2,195.15,3,3,1,7
15615,10,23,10399.74,5,5,5,15
15618,32,4,776.851,4,4,3,11
15619,10,1,336.40000000000003,5,1,2,8
15620,56,3,1553.18,3,3,4,10
15621,4,4,1293.03,5,4,4,13
15622,43,9,3709.56,3,5,5,13
15623,141,1,301.03,2,1,2,5
15624,116,4,588.13,2,4,3,9
15625,103,4,1534.26,2,4,4,10
15626,74,2,675.8,2,3,3,8
15628,4,9,2870.2400000000002,5,5,5,15
15630,45,2,1186.35,3,3,4,10
15632,15,8,3285.31,4,5,5,14
15634,17,1,243.55,4,1,1,6
15636,89,2,724.76,2,3,3,8
15637,52,1,223.36,3,1,1,5
15639,134,1,425.32,2,1,2,5
15640,4,15,12515.66,5,5,5,15
15641,105,4,1887.2,2,4,4,10
15643,191,3,664.0,1,3,3,7
15644,166,4,813.0,2,4,3,9
15645,18,1,612.01,4,1,3,8
15646,157,3,447.64000000000004,2,3,2,7
15648,204,2,657.35,1,3,3,7
15649,336,2,816.0,1,3,3,7
15651,36,3,646.3,3,3,3,9
15652,91,1,337.74,2,1,2,5
15653,92,2,877.4399999999999,2,3,3,8
15654,9,2,922.53,5,3,3,11
15655,243,1,560.67,1,1,3,5
15656,45,4,748.5,3,4,3,10
15657,22,1,30.0,4,1,1,6
15658,190,5,1024.1000000000001,1,4,4,9
15659,43,1,306.45,3,1,2,6
15660,25,9,1600.86,4,5,4,13
15661,317,2,309.8,1,3,2,6
15663,106,1,138.14,2,1,1,4
15664,50,1,386.43,3,1,2,6
15665,168,2,2242.01,2,3,5,10
15667,39,1,301.32,3,1,2,6
15668,217,1,76.32000000000001,1,1,1,3
15669,40,4,684.34,3,4,3,10
15670,296,1,173.05,1,1,1,3
15671,18,7,2657.13,4,5,5,14
15673,88,4,2881.02,2,4,5,11
15674,73,5,2446.6,2,4,5,11
15675,81,3,323.69,2,3,2,7
15676,18,3,3435.76,4,3,5,12
15677,49,1,657.23,3,1,3,7
15678,52,1,352.7,3,1,2,6
15679,24,4,781.28,4,4,3,11
15680,9,3,1333.68,5,3,4,12
15681,25,5,1426.16,4,4,4,12
15683,117,1,193.75,2,1,1,4
15687,8,9,2993.1,5,5,5,15
15689,119,2,254.1,2,3,2,7
15690,4,2,239.76,5,3,1,9
15691,252,1,136.8,1,1,1,3
15692,28,1,191.04,4,1,1,6
15694,0,14,6479.4,5,5,5,15
15695,266,2,409.98,1,3,2,6
15696,33,8,2736.46,3,5,5,13
15699,17,1,309.65,4,1,2,7
15700,172,2,696.68,2,3,3,8
15701,2,4,1542.14,5,4,4,13
15703,264,1,211.5,1,1,1,3
15704,140,4,2293.62,2,4,5,11
15705,201,1,143.1,1,1,1,3
15706,63,4,1060.56,3,4,4,11
15707,35,4,945.58,3,4,4,11
15708,40,7,3364.2400000000002,3,5,5,13
15709,283,1,133.25,1,1,1,3
15712,9,5,1072.3600000000001,5,4,4,13
15713,143,2,356.7,2,3,2,7
15714,11,2,330.88,5,3,2,10
15716,145,4,1118.81,2,4,4,10
15717,234,1,150.3,1,1,1,3
15719,32,13,5045.61,4,5,5,14
15720,24,1,598.73,4,1,3,8
15721,11,1,507.08,5,1,3,9
15722,35,5,2222.56,3,4,5,12
15723,364,1,203.1,1,1,1,3
15724,201,2,218.25,1,3,1,5
15725,15,1,415.25,4,1,2,7
15727,16,7,5178.96,4,5,5,14
15729,212,1,85.0,1,1,1,3
15730,65,3,1120.88,3,3,4,10
15732,212,2,294.12,1,3,2,6
15733,282,1,162.3,1,1,1,3
15734,114,2,1339.45,2,3,4,9
15737,14,8,1205.1200000000001,4,5,4,13
15738,18,16,4812.42,4,5,5,14
15739,66,1,449.12,3,1,2,6
15740,49,1,154.88,3,1,1,5
15743,16,4,784.46,4,4,3,11
15744,77,1,34.8,2,1,1,4
15745,19,4,1094.59,4,4,4,12
15746,134,1,196.88,2,1,1,4
15747,12,3,974.04,5,3,4,12
15748,40,1,149.31,3,1,1,5
15749,235,3,44534.3,1,3,5,9
15750,2,8,2465.48,5,5,5,15
15752,39,7,2637.38,3,5,5,13
15753,304,1,79.2,1,2,1,4
15754,51,3,458.57,3,3,2,8
15755,10,6,2364.25,5,5,5,15
15756,61,4,532.96,3,4,3,10
15757,65,2,714.42,3,3,3,9
15758,24,1,205.25,4,2,1,7
15759,218,3,253.04,1,4,2,7
15762,65,2,583.75,3,3,3,9
15763,31,2,1086.92,4,3,4,11
15764,88,6,3279.97,2,5,5,12
15766,64,1,315.06,3,2,2,7
15768,115,3,621.8299999999999,2,4,3,9
15769,7,26,56252.72,5,5,5,15
15773,5,1,635.6800000000001,5,2,3,10
15774,68,1,270.8,3,2,2,7
15775,245,1,104.9,1,2,1,4
15776,133,1,241.62,2,2,1,5
15777,241,4,1047.11,1,4,4,9
15780,183,3,475.28000000000003,1,4,2,7
15781,25,3,345.46,4,4,2,10
15782,9,3,2614.7400000000002,5,4,5,14
15783,10,1,246.3,5,2,1,8
15785,32,5,2328.9700000000003,4,4,5,13
15786,46,3,4932.2,3,4,5,12
15787,26,3,948.05,4,4,4,12
15789,358,1,351.3,1,2,2,5
15790,10,1,220.85,5,2,1,8
15791,43,2,1612.69,3,3,4,10
15793,14,3,965.61,4,4,4,12
15795,149,1,610.01,2,2,3,7
15796,1,8,2711.56,5,5,5,15
15797,113,4,2207.4,2,4,5,11
15799,75,3,884.14,2,4,3,9
15800,107,2,699.08,2,3,3,8
15801,46,3,1063.95,3,4,4,11
15802,142,1,451.42,2,2,2,6
15803,51,1,415.82000000000005,3,2,2,7
15804,0,13,4206.39,5,5,5,15
15805,23,17,5528.4800000000005,4,5,5,14
15806,46,3,784.58,3,4,3,10
15807,50,3,903.9,3,4,3,10
15808,306,4,3734.9700000000003,1,4,5,10
15809,36,5,515.77,3,4,3,10
15810,78,4,1391.98,2,4,4,10
15811,22,6,2218.62,4,5,5,14
15812,107,5,1801.14,2,4,4,10
15813,207,2,1303.9099999999999,1,3,4,8
15814,16,4,1945.33,4,4,4,12
15815,63,5,2100.6,3,4,5,12
15819,49,4,1905.45,3,4,4,11
15820,319,1,206.98,1,2,1,4
15821,44,2,570.96,3,3,3,9
15822,3,2,885.47,5,3,3,11
15823,372,1,15.0,1,2,1,4
15825,172,1,532.94,2,2,3,7
15826,56,3,1654.31,3,4,4,11
15827,73,14,1836.0900000000001,2,5,4,11
15829,99,2,636.14,2,3,3,8
15830,37,1,576.0,3,2,3,8
15831,58,3,801.76,3,4,3,10
15832,254,1,836.79,1,2,3,6
15834,70,4,2233.75,3,4,5,12
15835,44,4,954.09,3,4,4,11
15836,50,1,137.37,3,2,1,6
15837,64,1,391.98,3,2,2,7
15838,11,19,33643.08,5,5,5,15
15839,33,3,1048.49,3,4,4,11
15840,58,2,355.56,3,3,2,8
15841,72,4,1224.06,2,4,4,10
15843,303,1,118.95000000000002,1,2,1,4
15844,46,1,130.73999999999998,3,2,1,6
15845,17,8,3711.77,4,5,5,14
15847,38,2,389.27,3,3,2,8
15850,19,2,238.85,4,3,1,8
15852,186,2,160.71,1,3,1,5
15853,51,1,110.8,3,2,1,6
15854,4,12,2974.65,5,5,5,15
15855,136,5,712.24,2,4,3,9
15856,4,27,16387.57,5,5,5,15
15857,18,1,297.0,4,2,2,8
15858,15,5,1438.85,4,4,4,12
15860,40,8,977.21,3,5,4,12
15861,12,8,3165.36,5,5,5,15
15862,8,4,832.88,5,4,3,12
15863,25,2,68.84,4,3,1,8
15864,22,6,1936.3200000000002,4,5,4,13
15865,40,3,895.13,3,4,3,10
15866,101,1,230.53,2,2,1,5
15867,5,15,3812.64,5,5,5,15
15869,277,2,149.64,1,3,1,5
15870,32,1,354.09000000000003,4,2,2,8
15872,14,2,360.93,4,3,2,9
15874,63,7,4405.88,3,5,5,13
15877,1,2,493.28,5,3,3,11
15880,369,1,343.28000000000003,1,2,2,5
15881,312,5,501.39000000000004,1,4,3,8
15882,198,4,516.36,1,4,3,8
15883,2,2,396.48,5,3,2,10
15885,92,3,379.35,2,4,2,8
15886,60,1,181.09,3,2,1,6
15888,80,1,168.31,2,2,1,5
15889,156,2,446.87,2,3,2,7
15891,226,1,524.52,1,2,3,6
15894,253,2,263.55,1,3,2,6
15895,149,1,179.17,2,2,1,5
15897,194,2,222.05,1,3,1,5
15898,1,5,1388.88,5,4,4,13
15899,368,1,56.25,1,2,1,4
15900,23,1,351.11,4,2,2,8
15901,16,3,363.88,4,4,2,10
15903,9,7,5126.76,5,5,5,15
15904,8,1,164.68,5,2,1,8
15906,19,7,1567.69,4,5,4,13
15907,3,3,967.45,5,4,4,13
15909,173,1,191.94,2,2,1,5
15910,0,8,1232.18,5,5,4,14
15912,178,2,264.62,2,3,2,7
15916,16,8,1528.09,4,5,4,13
15917,247,1,123.1,1,2,1,4
15918,190,2,334.23,1,3,2,6
15919,19,2,639.89,4,3,3,10
15920,154,4,167.5,2,4,1,7
15921,172,1,336.03000000000003,2,2,2,6
15922,373,1,369.5,1,2,2,5
15923,372,1,127.08,1,2,1,4
15925,194,1,207.15,1,2,1,4
15930,67,1,426.63,3,2,2,7
15932,4,8,2495.87,5,5,5,15
15933,21,3,1107.46,4,4,4,12
15935,239,2,416.86,1,3,2,6
15937,64,1,145.35,3,2,1,6
15938,112,5,404.58,2,4,2,8
15939,89,15,6115.01,2,5,5,12
15940,311,1,35.8,1,2,1,4
15942,133,1,337.44,2,2,2,6
15944,276,1,325.1,1,2,2,5
15945,365,1,181.0,1,2,1,4
15947,82,1,1708.24,2,2,4,8
15948,8,2,955.24,5,3,4,12
15949,16,2,364.72,4,3,2,9
15950,31,4,1765.51,4,4,4,12
15951,8,2,708.22,5,3,3,11
15952,33,4,806.57,3,4,3,10
15953,15,8,1659.3799999999999,4,5,4,13
15955,24,14,4416.26,4,5,5,14
15957,31,1,428.89,4,2,2,8
15958,74,1,104.35,2,2,1,5
15963,19,2,470.76,4,3,2,9
15965,17,4,845.64,4,4,3,11
15967,23,2,418.83,4,3,2,9
15969,2,3,666.1,5,4,3,12
15970,303,1,314.1,1,2,2,5
15971,17,12,4199.85,4,5,5,14
15973,366,1,307.82000000000005,1,2,2,5
15974,39,7,3442.15,3,5,5,13
15975,84,1,371.01,2,2,2,6
15976,165,2,430.94,2,3,2,7
15977,17,2,1054.73,4,3,4,11
15978,77,1,1098.78,2,2,4,8
15980,88,3,2398.86,2,4,5,11
15981,24,8,3408.48,4,5,5,14
15983,22,4,1475.02,4,4,4,12
15984,2,10,2837.67,5,5,5,15
15985,123,2,1142.42,2,3,4,9
15986,30,1,168.12,4,2,1,7
15987,12,7,1451.28,5,5,4,14
15988,19,1,158.03,4,2,1,7
15990,44,2,792.11,3,3,3,9
15992,3,1,41.989999999999995,5,2,1,8
15993,8,7,2797.57,5,5,5,15
15994,54,1,427.07,3,2,2,7
15996,88,6,1060.68,2,5,4,11
15998,36,5,3089.97,3,4,5,12
16000,2,3,12393.7,5,4,5,14
16003,29,5,2735.37,4,4,5,13
16005,12,4,615.39,5,4,3,12
16006,211,1,101.4,1,2,1,4
16007,47,4,1701.94,3,4,4,11
16008,23,3,478.78,4,4,2,10
16009,22,4,992.71,4,4,4,12
16010,245,3,407.5,1,4,2,7
16011,8,16,3362.71,5,5,5,15
16012,35,3,1415.29,3,4,4,11
16013,3,47,37130.6,5,5,5,15
16014,37,3,662.38,3,4,3,10
16015,3,3,705.39,5,4,3,12
16016,3,8,1508.76,5,5,4,14
16017,47,1,211.88,3,2,1,6
16018,39,2,408.90000000000003,3,3,2,8
16019,46,9,3786.2400000000002,3,5,5,13
16020,16,3,851.01,4,4,3,11
16022,260,1,628.28,1,2,3,6
16023,46,3,719.81,3,4,3,10
16024,12,1,251.24,5,2,2,9
16025,29,1,439.65999999999997,4,2,2,8
16026,43,1,236.09,3,2,1,6
16027,91,6,934.62,2,5,3,10
16029,38,63,81024.84,3,5,5,13
16030,309,1,331.24,1,2,2,5
16031,92,2,548.94,2,3,3,8
16033,5,20,8816.4,5,5,5,15
16034,196,3,437.7,1,4,2,7
16036,87,2,758.92,2,3,3,8
16037,269,3,855.02,1,4,3,8
16038,7,3,471.78000000000003,5,4,2,11
16040,65,3,1313.55,3,4,4,11
16041,30,3,3166.4,4,4,5,13
16042,22,5,1197.27,4,4,4,12
16043,37,4,773.99,3,4,3,10
16045,119,4,1340.7,2,4,4,10
16048,373,2,256.44,1,3,2,6
16049,40,3,1111.79,3,4,4,11
16050,173,1,137.9,2,2,1,5
16052,54,1,362.06,3,2,2,7
16053,32,2,1511.95,4,3,4,11
16054,145,1,783.9,2,2,3,7
16055,220,1,134.8,1,2,1,4
16056,45,1,664.85,3,2,3,8
16057,16,7,2263.12,4,5,5,14
16059,65,6,1459.8600000000001,3,5,4,12
16062,9,4,1153.62,5,4,4,13
16063,260,1,335.32,1,2,2,5
16065,365,1,372.09,1,2,2,5
16066,16,5,1521.87,4,4,4,12
16070,22,2,852.15,4,3,3,10
16071,44,1,326.24,3,2,2,7
16072,288,1,584.3199999999999,1,2,3,6
16073,297,1,122.39999999999999,1,2,1,4
16076,3,10,2234.73,5,5,5,15
16078,283,1,79.2,1,2,1,4
16079,16,3,1352.0,4,4,4,12
16080,81,2,217.16,2,3,1,6
16081,56,5,2806.9,3,4,5,12
16083,100,2,1317.62,2,3,4,9
16084,299,1,436.18,1,2,2,5
16085,23,5,981.51,4,4,4,12
16086,59,5,1121.39,3,4,4,11
16091,154,2,315.06,2,3,2,7
16092,114,3,817.86,2,4,3,9
16093,106,1,17.0,2,2,1,5
16094,11,4,1078.23,5,4,4,13
16096,264,1,320.62,1,2,2,5
16097,240,1,185.04999999999998,1,2,1,4
16098,87,7,2005.63,2,5,4,11
16099,50,3,731.9,3,4,3,10
16101,70,1,1290.7,3,2,4,9
16102,42,3,1842.14,3,4,4,11
16103,7,6,1429.64,5,5,4,14
16104,61,1,302.36,3,2,2,7
16105,248,1,336.96,1,2,2,5
16106,65,1,108.38,3,2,1,6
16107,17,7,3204.1600000000003,4,5,5,14
16108,84,1,842.5,2,2,3,7
16109,218,2,611.88,1,3,3,7
16110,45,3,1337.48,3,4,4,11
16112,143,4,195.73999999999998,2,4,1,7
16113,183,1,161.38,1,2,1,4
16114,170,1,135.75000000000003,2,2,1,5
16115,9,8,1667.97,5,5,4,14
16116,211,1,612.78,1,2,3,6
16117,189,1,232.21,1,2,1,4
16119,8,2,423.36,5,3,2,10
16120,59,4,1309.14,3,4,4,11
16121,57,2,867.11,3,3,3,9
16122,73,4,684.4200000000001,2,4,3,9
16123,51,1,307.78,3,2,2,7
16124,317,1,249.0,1,2,1,4
16125,367,1,289.35,1,2,2,5
16126,29,4,6287.77,4,4,5,13
16127,39,1,656.25,3,2,3,8
16128,17,5,1880.22,4,4,4,12
16131,51,6,3506.54,3,5,5,13
16133,3,33,14589.04,5,5,5,15
16134,21,2,618.09,4,3,3,10
16135,262,1,517.55,1,2,3,6
16136,59,3,709.38,3,4,3,10
16139,18,3,635.41,4,4,3,11
16140,65,2,725.18,3,3,3,9
16141,88,1,620.4,2,2,3,7
16142,249,1,535.34,1,2,3,6
16143,3,6,2424.94,5,5,5,15
16144,246,1,175.2,1,2,1,4
16145,8,11,3799.4900000000002,5,5,5,15
16146,157,3,734.13,2,4,3,9
16147,133,1,375.0,2,2,2,6
16148,296,1,76.32000000000001,1,2,1,4
16149,4,2,280.52,5,3,2,10
16150,42,5,2053.02,3,4,4,11
16152,268,1,1829.04,1,2,4,7
16153,49,5,1824.23,3,4,4,11
16156,8,9,3122.04,5,5,5,15
16157,15,3,656.69,4,4,3,11
16159,281,1,348.2,1,2,2,5
16160,65,2,1025.44,3,3,4,10
16161,1,19,5575.56,5,5,5,15
16162,252,1,37.4,1,2,1,4
16163,232,2,856.6,1,3,3,7
16164,17,3,822.48,4,4,3,11
16168,10,27,3787.6,5,5,5,15
16169,8,4,1822.97,5,4,4,13
16170,50,6,1885.05,3,5,4,12
16171,59,1,73.2,3,2,1,6
16172,95,5,1140.21,2,4,4,10
16173,15,6,1418.32,4,5,4,13
16174,126,3,1009.5500000000001,2,4,4,10
16175,94,4,1037.59,2,4,4,10
16177,50,1,331.95,3,2,2,7
16178,138,1,197.9,2,2,1,5
16179,60,1,215.83,3,2,1,6
16180,100,8,10254.18,2,5,5,12
16181,73,1,305.54,2,2,2,6
16182,72,4,6617.65,2,4,5,11
16183,67,1,338.71000000000004,3,2,2,7
16184,64,6,1158.79,3,5,4,12
16185,16,2,529.41,4,3,3,10
16186,22,12,4006.94,4,5,5,14
16187,31,15,6911.4400000000005,4,5,5,14
16188,44,4,981.86,3,4,4,11
16189,15,2,215.48,4,3,1,8
16190,40,1,215.08,3,2,1,6
16191,2,13,5180.52,5,5,5,15
16193,236,1,314.45,1,2,2,5
16198,75,1,400.68100000000004,2,2,2,6
16200,4,2,1080.6200000000001,5,3,4,12
16201,3,4,1863.47,5,4,4,13
16202,360,1,365.27,1,2,2,5
16203,58,4,592.9,3,4,3,10
16204,23,1,405.71,4,2,2,8
16205,30,4,761.38,4,4,3,11
16206,54,4,537.0600000000001,3,4,3,10
16207,25,1,394.38,4,2,2,8
16208,44,2,664.26,3,3,3,9
16209,88,5,2262.62,2,4,5,11
16210,1,18,21086.3,5,5,5,15
16211,88,1,547.02,2,2,3,7
16212,19,2,690.34,4,3,3,10
16213,78,1,159.0,2,2,1,5
16214,170,3,1062.75,2,4,4,10
16215,80,1,242.35,2,2,1,5
16216,267,1,914.9300000000001,1,2,3,6
16217,235,2,304.25,1,3,2,6
16218,29,7,3084.68,4,5,5,14
16221,36,3,864.86,3,4,3,10
16222,318,1,846.72,1,2,3,6
16224,57,4,1295.3,3,4,4,11
16225,44,5,1096.32,3,4,4,11
16226,203,3,255.12,1,4,2,7
16227,225,1,314.22,1,2,2,5
16229,87,2,1010.6,2,3,4,9
16230,189,2,542.03,1,3,3,7
16232,43,4,990.88,3,4,4,11
16233,71,3,536.6800000000001,3,4,3,10
16235,40,5,867.31,3,4,3,10
16236,78,1,432.2,2,2,2,6
16239,56,2,414.2,3,3,2,8
16240,24,2,3718.8,4,3,5,12
16241,9,13,2607.87,5,5,5,15
16242,8,7,3603.21,5,5,5,15
16243,33,2,409.1,3,3,2,8
16244,211,2,1522.75,1,3,4,8
16245,23,3,1413.66,4,4,4,12
16247,170,1,114.56,2,2,1,5
16248,61,1,152.94,3,2,1,6
16249,52,5,1800.07,3,4,4,11
16250,261,2,389.44,1,3,2,6
16253,66,2,3683.86,3,3,5,11
16255,16,8,2619.91,4,5,5,14
16256,266,1,752.4300000000001,1,2,3,6
16257,176,1,46.95,2,2,1,5
16258,45,5,5203.51,3,4,5,12
16260,50,1,1035.45,3,2,4,9
16261,17,4,746.83,4,4,3,11
16265,9,9,5447.0,5,5,5,15
16266,73,7,861.89,2,5,3,10
16268,71,2,667.65,3,3,3,9
16270,353,1,1141.24,1,2,4,7
16271,2,5,1429.24,5,4,4,13
16272,116,1,411.7,2,2,2,6
16274,373,1,357.95,1,2,2,5
16275,196,1,559.87,1,2,3,6
16276,176,1,810.6000000000001,2,2,3,7
16278,100,1,566.38,2,2,3,7
16279,21,3,1509.58,4,4,4,12
16281,72,1,2062.06,2,2,5,9
16282,339,1,168.3,1,2,1,4
16283,5,5,1570.81,5,4,4,13
16284,31,2,823.97,4,3,3,10
16287,169,1,142.5,2,2,1,5
16292,121,1,302.25,2,2,2,6
16293,21,10,2248.9900000000002,4,5,5,14
16295,9,4,1328.55,5,4,4,13
16297,268,1,301.9,1,2,2,5
16298,22,3,598.2,4,4,3,11
16302,126,1,233.22,2,2,1,5
16303,25,3,5360.63,4,4,5,13
16305,138,1,361.21999999999997,2,2,2,6
16306,213,6,632.27,1,5,3,9
16308,37,4,2560.0,3,4,5,12
16309,106,2,706.57,2,3,3,8
16311,17,2,616.26,4,3,3,10
16313,3,2,274.15000000000003,5,3,2,10
16315,330,1,226.37,1,2,1,4
16316,64,8,2938.91,3,5,5,13
16317,119,3,1341.65,2,4,4,10
16318,35,1,328.15,3,2,2,7
16319,217,1,404.40000000000003,1,2,2,5
16320,172,2,1038.46,2,3,4,9
16321,72,5,373.65000000000003,2,4,2,8
16322,1,2,326.75,5,3,2,10
16323,196,1,207.50000000000003,1,2,1,4
16324,128,3,428.68,2,4,2,8
16325,46,3,594.24,3,4,3,10
16326,5,14,3110.96,5,5,5,15
16327,14,6,3844.22,4,5,5,14
16330,17,3,251.91,4,4,2,10
16332,28,7,1593.2,4,5,4,13
16333,7,22,26626.8,5,5,5,15
16337,36,1,151.05,3,2,1,6
16338,157,1,214.79999999999998,2,2,1,5
16339,284,1,109.95,1,2,1,4
16340,107,1,549.07,2,2,3,7
16341,24,4,1971.87,4,4,4,12
16342,75,4,322.41,2,4,2,8
16343,16,2,370.47999999999996,4,3,2,9
16344,158,1,101.10000000000001,2,2,1,5
16345,44,1,575.41,3,2,3,8
16347,11,2,887.65,5,3,3,11
16348,32,7,1469.45,4,5,4,13
16349,290,1,53.5,1,2,1,4
16350,21,4,1116.47,4,4,4,12
16351,332,1,153.9,1,2,1,4
16352,17,2,494.44,4,3,3,10
16353,3,23,6675.71,5,5,5,15
16354,63,2,395.8,3,3,2,8
16356,197,3,211.77,1,4,1,6
16357,33,3,658.88,3,4,3,10
16358,1,4,2027.5,5,4,4,13
16359,7,9,1750.92,5,5,4,14
16360,4,6,3512.53,5,5,5,15
16361,9,4,896.66,5,4,3,12
16362,32,5,734.77,4,4,3,11
16363,53,1,109.36000000000001,3,2,1,6
16364,11,2,707.04,5,3,3,11
16365,17,9,1540.42,4,5,4,13
16366,18,1,327.3,4,2,2,8
16367,37,2,804.49,3,3,3,9
16368,2,2,497.43,5,3,3,11
16369,18,3,1553.66,4,4,4,12
16370,82,4,1320.56,2,4,4,10
16372,33,2,367.93,3,3,2,8
16374,66,2,473.03000000000003,3,3,2,8
16376,8,2,987.01,5,3,4,12
16377,267,1,676.2,1,2,3,6
16378,247,3,362.95,1,4,2,7
16379,4,4,2157.4,5,4,5,14
16380,61,1,1780.59,3,2,4,9
16383,74,2,668.36,2,3,3,8
16384,89,2,584.5,2,3,3,8
16385,60,3,555.89,3,4,3,10
16386,28,2,317.2,4,3,2,9
16387,322,1,94.36,1,2,1,4
16389,53,4,1382.07,3,4,4,11
16392,269,1,221.19,1,2,1,4
16393,2,13,3046.21,5,5,5,15
16394,56,5,1555.34,3,4,4,11
16395,60,5,1486.9,3,4,4,11
16398,154,2,1705.8,2,3,4,9
16399,19,2,408.57,4,3,2,9
16400,94,1,303.93,2,2,2,6
16401,1,12,4098.32,5,5,5,15
16402,264,2,299.6,1,3,2,6
16403,312,1,177.5,1,2,1,4
16404,70,1,443.05,3,2,2,7
16405,302,2,167.25,1,3,1,5
16406,18,1,163.07,4,2,1,7
16407,12,10,2126.93,5,5,5,15
16409,36,5,2028.88,3,4,4,11
16411,19,2,214.65,4,3,1,8
16412,53,1,151.83,3,2,1,6
16413,56,1,262.2,3,2,2,7
16414,21,2,126.25,4,3,1,8
16415,44,1,210.35,3,2,1,6
16416,26,3,1051.4,4,4,4,12
16418,44,3,675.27,3,4,3,10
16419,112,6,972.23,2,5,4,11
16422,17,51,34684.4,4,5,5,14
16423,24,1,346.12,4,2,2,8
16424,191,1,133.56,1,2,1,4
16425,302,1,302.7,1,2,2,5
16426,2,10,1908.25,5,5,4,14
16427,263,2,241.06,1,3,1,5
16429,106,1,284.55,2,2,2,6
16430,57,1,300.85,3,2,2,7
16431,213,3,642.81,1,4,3,8
16432,64,1,287.4,3,2,2,7
16433,28,1,184.26,4,2,1,7
16434,29,7,1522.25,4,5,4,13
16438,5,5,798.35,5,4,3,12
16440,7,5,3640.67,5,4,5,14
16441,67,2,381.2,3,3,2,8
16442,1,3,616.79,5,4,3,12
16444,46,4,654.67,3,4,3,10
16445,33,1,230.51,3,2,1,6
16446,0,2,168472.5,5,3,5,13
16447,135,1,259.01,2,2,2,6
16448,198,1,188.89000000000001,1,2,1,4
16449,197,2,707.69,1,3,3,7
16450,149,1,311.92,2,2,2,6
16451,87,1,266.97,2,2,2,6
16454,44,2,6.9,3,3,1,7
16455,63,7,1841.18,3,5,4,12
16456,99,5,2158.37,2,4,5,11
16457,218,1,208.36,1,2,1,4
16458,2,18,3482.7400000000002,5,5,5,15
16460,28,3,814.72,4,4,3,11
16461,177,1,151.42,2,2,1,5
16462,73,3,136.0,2,4,1,7
16463,21,4,1422.4,4,4,4,12
16464,19,3,1314.68,4,4,4,12
16466,33,7,1603.46,3,5,4,12
16468,74,1,74.9,2,2,1,5
16469,23,4,650.43,4,4,3,11
16470,51,4,762.39,3,4,3,10
16471,274,1,223.95000000000002,1,2,1,4
16473,164,3,316.11,2,4,2,8
16474,7,7,1871.5,5,5,4,14
16475,88,4,544.3,2,4,3,9
16477,63,7,2494.46,3,5,5,13
16478,25,3,331.0,4,4,2,10
16479,10,2,300.83,5,3,2,10
16480,75,1,769.29,2,2,3,7
16482,15,1,220.62,4,2,1,7
16483,192,1,139.35,1,2,1,4
16484,173,2,404.3,2,3,2,7
16485,77,1,363.65,2,2,2,6
16488,33,3,498.8,3,4,3,10
16491,46,1,731.5,3,2,3,8
16493,79,4,1351.63,2,4,4,10
16494,296,1,826.53,1,2,3,6
16495,3,3,684.41,5,4,3,12
16496,8,3,1599.52,5,4,4,13
16497,49,6,2965.69,3,5,5,13
16498,161,2,100.97,2,3,1,6
16499,360,2,365.45,1,3,2,6
16500,4,6,400.86,5,5,2,12
16503,106,4,1431.93,2,4,4,10
16504,25,1,484.38,4,2,2,8
16505,31,1,777.6,4,2,3,9
16506,19,2,90.30000000000001,4,3,1,8
16509,296,1,363.7,1,2,2,5
16510,372,1,248.1,1,2,1,4
16511,21,3,950.26,4,4,4,12
16513,4,4,874.59,5,4,3,12
16515,52,5,1627.13,3,4,4,11
16516,30,1,101.69999999999999,4,2,1,7
16517,277,1,162.7,1,2,1,4
16518,61,2,484.32,3,3,2,8
16519,25,2,215.07999999999998,4,3,1,8
16520,186,3,1046.57,1,4,4,9
16523,1,21,9418.470000000001,5,5,5,15
16525,2,26,13027.45,5,5,5,15
16526,171,1,290.36,2,2,2,6
16527,81,1,228.06,2,2,1,5
16528,3,1,244.41,5,2,1,8
16529,190,1,455.25,1,2,2,5
16531,22,7,1244.59,4,5,4,13
16532,17,3,6748.8,4,4,5,13
16533,19,3,1095.56,4,4,4,12
16535,5,1,593.75,5,2,3,10
16536,110,1,548.97,2,2,3,7
16539,2,4,1388.81,5,4,4,13
16542,53,1,119.62,3,2,1,6
16545,164,1,339.3,2,2,2,6
16546,290,2,787.15,1,3,3,7
16549,10,10,4154.64,5,5,5,15
16550,108,5,2298.97,2,4,5,11
16551,95,3,922.12,2,4,3,9
16552,242,2,379.73,1,3,2,6
16553,163,12,5719.82,2,5,5,12
16554,42,3,837.1,3,4,3,10
16555,35,2,285.89,3,3,2,8
16556,66,7,3313.79,3,5,5,13
16557,24,2,281.85,4,3,2,9
16558,0,20,8338.49,5,5,5,15
16560,26,2,841.41,4,3,3,10
16561,5,2,511.12,5,3,3,11
16563,53,1,1077.74,3,2,4,9
16565,364,1,173.7,1,2,1,4
16566,15,5,614.66,4,4,3,11
16567,194,2,865.6,1,3,3,7
16569,3,1,124.2,5,2,1,8
16570,15,10,3738.4,4,5,5,14
16571,26,3,1421.69,4,4,4,12
16572,127,3,1009.6,2,4,4,10
16573,84,2,663.61,2,3,3,8
16574,71,1,451.44,3,2,2,7
16581,182,1,105.84,1,2,1,4
16582,113,1,313.62,2,2,2,6
16583,373,1,233.45,1,2,1,4
16584,80,2,936.08,2,3,3,8
16586,248,1,463.95,1,2,2,5
16587,232,1,225.15,1,2,1,4
16589,71,3,459.24,3,4,2,9
16591,68,1,213.5,3,2,1,6
16592,4,16,4113.68,5,5,5,15
16593,50,3,330.03,3,4,2,9
16594,75,1,181.09,2,2,1,5
16595,61,1,360.16,3,2,2,7
16596,15,2,250.15,4,3,2,9
16597,4,1,90.04,5,2,1,8
16598,285,1,145.04999999999998,1,2,1,4
16600,4,6,813.52,5,5,3,13
16601,40,1,244.79999999999998,3,2,1,6
16602,36,1,528.08,3,2,3,8
16603,74,2,482.47,2,3,2,7
16607,17,14,3347.71,4,5,5,14
16609,15,7,5493.46,4,5,5,14
16610,219,1,75.66,1,2,1,4
16611,186,1,129.49,1,2,1,4
16612,32,4,1187.66,4,4,4,12
16613,70,1,618.59,3,2,3,8
16614,182,1,506.19,1,2,3,6
16616,15,2,500.42,4,3,3,10
16617,235,1,151.85,1,2,1,4
16618,31,5,2647.59,4,4,5,13
16619,263,1,226.21,1,2,1,4
16620,3,2,178.96,5,3,1,9
16621,51,4,813.48,3,4,3,10
16623,245,1,129.45,1,2,1,4
16624,80,2,810.5699999999999,2,3,3,8
16625,274,1,333.08,1,2,2,5
16626,0,17,4413.1,5,5,5,15
16627,79,1,322.8,2,2,2,6
16628,29,5,2188.05,4,4,5,13
16629,73,2,417.73,2,3,2,7
16633,17,6,2883.1,4,5,5,14
16634,222,2,217.9,1,3,1,5
16637,32,4,1154.47,4,4,4,12
16638,22,10,1680.72,4,5,4,13
16639,31,3,1257.51,4,4,4,12
16641,105,1,231.10000000000002,2,2,1,5
16642,4,2,688.33,5,3,3,11
16643,245,1,487.51,1,2,2,5
16644,177,2,833.78,2,3,3,8
16647,169,2,214.06,2,3,1,6
16648,42,1,290.65999999999997,3,2,2,7
16650,71,1,518.42,3,2,3,8
16652,58,7,6773.97,3,5,5,13
16653,16,2,1212.66,4,3,4,11
16654,141,4,601.27,2,4,3,9
16655,17,6,3794.52,4,5,5,14
16656,22,15,8625.8,4,5,5,14
16657,9,4,933.62,5,4,3,12
16658,368,1,123.24,1,2,1,4
16659,189,1,39.12,1,2,1,4
16660,16,4,1267.6499999999999,4,4,4,12
16665,362,1,135.39999999999998,1,2,1,4
16666,19,1,118.98,4,2,1,7
16667,68,2,570.13,3,3,3,9
16668,15,6,306.71999999999997,4,5,2,11
16669,23,3,1374.8700000000001,4,4,4,12
16670,16,11,4095.9,4,5,5,14
16671,28,3,1692.27,4,4,4,12
16672,2,20,8134.9400000000005,5,5,5,15
16674,54,2,319.61,3,3,2,8
16676,33,4,1592.1200000000001,3,4,4,11
16678,2,12,3109.99,5,5,5,15
16679,366,1,129.75,1,2,1,4
16680,43,1,183.7,3,2,1,6
16681,72,6,1770.34,2,5,4,11
16682,4,5,1028.0,5,4,4,13
16684,4,28,66653.56,5,5,5,15
16685,61,2,324.24,3,3,2,8
16686,47,7,3062.83,3,5,5,13
16688,1,4,1260.86,5,4,4,13
16689,75,2,422.59999999999997,2,3,2,7
16690,72,2,225.57999999999998,2,3,1,6
16692,256,2,1276.0,1,3,4,8
16693,68,2,482.01,3,3,2,8
16696,135,4,657.9000000000001,2,4,3,9
16697,241,1,112.75,1,2,1,4
16698,226,2,1998.0,1,3,4,8
16700,8,13,5076.55,5,5,5,15
16701,8,13,5398.3,5,5,5,15
16705,0,20,14034.99,5,5,5,15
16706,37,3,531.35,3,4,3,10
16708,45,1,656.63,3,2,3,8
16709,84,5,3029.87,2,4,5,11
16710,19,10,2483.04,4,5,5,14
16711,3,5,1651.03,5,4,4,13
16712,9,11,3645.43,5,5,5,15
16713,18,15,6923.13,4,5,5,14
16714,218,3,1161.53,1,4,4,9
16715,78,1,301.71999999999997,2,2,2,6
16716,266,2,901.2,1,3,3,7
16717,23,6,3858.38,4,5,5,14
16718,369,1,623.75,1,2,3,6
16719,14,7,1790.42,4,5,4,13
16720,26,1,155.24,4,2,1,7
16721,262,1,292.47,1,2,2,5
16722,17,13,4730.81,4,5,5,14
16723,91,2,589.15,2,3,3,8
16725,302,7,781.02,1,5,3,9
16726,26,5,1382.02,4,4,4,12
16727,364,1,272.82,1,2,2,5
16728,46,4,1054.67,3,4,4,11
16729,38,21,7239.92,3,5,5,13
16730,52,3,743.11,3,4,3,10
16732,31,1,603.75,4,2,3,9
16734,52,3,650.51,3,4,3,10
16735,78,5,2300.56,2,4,5,11
16737,53,1,417.59999999999997,3,2,2,7
16738,297,1,3.75,1,2,1,4
16739,176,1,323.0,2,2,2,6
16742,46,1,464.9,3,2,2,7
16743,29,7,2238.09,4,5,5,14
16744,11,7,1304.76,5,5,4,14
16745,86,17,7194.3,2,5,5,12
16746,4,18,6697.66,5,5,5,15
16747,37,2,836.06,3,3,3,9
16748,17,5,1515.9,4,4,4,12
16750,44,5,623.93,3,4,3,10
16751,30,1,1764.72,4,2,4,10
16752,372,1,207.5,1,2,1,4
16753,58,1,223.92000000000002,3,2,1,6
16754,372,1,2002.4,1,2,4,7
16755,114,3,1496.83,2,4,4,10
16756,214,1,239.4,1,2,1,4
16757,318,1,106.83000000000001,1,2,1,4
16758,65,1,369.34000000000003,3,2,2,7
16759,7,3,789.79,5,4,3,12
16761,96,1,316.62,2,2,2,6
16762,19,3,1501.38,4,4,4,12
16763,198,1,611.85,1,2,3,6
16764,3,13,2799.25,5,5,5,15
16765,294,1,34.0,1,2,1,4
16766,273,2,1145.6,1,3,4,8
16767,30,11,5580.6,4,5,5,14
16768,47,3,478.09000000000003,3,4,2,9
16769,260,1,380.39,1,2,2,5
16770,57,5,770.1,3,4,3,10
16771,33,5,2246.81,3,4,5,12
16773,57,1,171.59,3,2,1,6
16774,67,4,661.52,3,4,3,10
16775,10,11,1695.66,5,5,4,14
16776,60,1,388.28,3,2,2,7
16777,80,2,226.35,2,3,1,6
16778,74,2,245.94,2,3,1,6
16779,2,22,10629.720000000001,5,5,5,15
16780,100,2,425.19,2,3,2,7
16781,372,1,311.25,1,2,2,5
16782,10,13,2279.9,5,5,5,15
16784,19,1,107.6,4,2,1,7
16788,123,2,597.48,2,3,3,8
16789,8,1,80.8,5,2,1,8
16790,3,6,1545.6200000000001,5,5,4,14
16791,29,7,1721.78,4,5,4,13
16792,282,2,110.38000000000001,1,3,1,5
16793,57,1,243.84,3,2,1,6
16794,1,10,1222.71,5,5,4,14
16795,365,1,414.88,1,2,2,5
16796,89,1,305.62,2,2,2,6
16800,11,1,1201.49,5,2,4,11
16801,163,4,1619.73,2,4,4,10
16803,65,1,332.3,3,2,2,7
16804,23,3,536.99,4,4,3,11
16805,173,2,460.59,2,3,2,7
16806,103,4,801.49,2,4,3,9
16807,142,3,1121.59,2,4,4,10
16808,99,2,288.42,2,3,2,7
16809,23,5,914.69,4,4,3,11
16810,192,1,309.54,1,2,2,5
16811,4,2,547.07,5,3,3,11
16812,360,1,479.35,1,2,2,5
16813,8,10,1692.98,5,5,4,14
16814,14,21,6509.1,4,5,5,14
16816,103,4,417.06,2,4,2,8
16817,2,9,1604.75,5,5,4,14
16818,10,11,3349.57,5,5,5,15
16820,95,1,497.61,2,2,3,7
16823,227,1,358.38,1,2,2,5
16824,15,2,460.64,4,3,2,9
16825,38,2,775.1800000000001,3,3,3,9
16826,51,1,341.7,3,2,2,7
16828,93,2,128.5,2,3,1,6
16829,156,1,197.22,2,2,1,5
16830,38,1,325.91,3,2,2,7
16832,184,3,199.15,1,4,1,6
16833,1,4,1106.53,5,4,4,13
16834,227,1,413.46,1,2,2,5
16835,128,2,180.85,2,3,1,6
16836,39,2,251.87,3,3,2,8
16837,31,11,3170.98,4,5,5,14
16838,197,2,588.85,1,3,3,7
16839,8,34,16594.35,5,5,5,15
16841,36,6,1869.82,3,5,4,12
16842,100,3,1264.19,2,4,4,10
16843,42,16,10196.57,3,5,5,13
16846,50,1,214.32,3,2,1,6
16847,43,1,193.44,3,2,1,6
16848,52,1,281.42,3,2,2,7
16849,186,1,124.57,1,2,1,4
16850,333,1,332.41,1,2,2,5
16851,4,3,342.45,5,4,2,11
16852,10,2,144.91000000000003,5,3,1,9
16855,23,2,328.4,4,3,2,9
16856,14,1,35.400000000000006,4,2,1,7
16858,368,1,375.69000000000005,1,2,2,5
16859,144,2,747.81,2,3,3,8
16861,59,2,173.76,3,3,1,7
16863,31,2,502.8,4,3,3,10
16866,140,3,207.73999999999998,2,4,1,7
16869,22,4,825.42,4,4,3,11
16871,22,6,2812.34,4,5,5,14
16872,77,3,680.02,2,4,3,9
16873,4,6,7123.62,5,5,5,15
16875,67,5,2095.53,3,4,5,12
16877,12,6,853.72,5,5,3,13
16878,84,1,13.3,2,2,1,5
16880,30,7,1519.08,4,5,4,13
16881,66,1,432.0,3,2,2,7
16882,66,3,705.12,3,4,3,10
16883,187,2,276.73,1,3,2,6
16884,37,2,429.84000000000003,3,3,2,8
16885,15,3,471.51,4,4,2,10
16887,35,1,194.88,3,2,1,6
16889,194,3,1578.67,1,4,4,9
16891,1,5,809.7,5,4,3,12
16892,1,5,525.54,5,4,3,12
16893,366,1,145.93,1,2,1,4
16895,64,1,219.14,3,2,1,6
16897,299,2,289.78,1,3,2,6
16898,26,3,508.81,4,4,3,11
16899,7,6,1281.56,5,5,4,14
16900,16,3,887.11,4,4,3,11
16902,116,1,1706.88,2,2,4,8
16903,29,1,373.24,4,2,2,8
16904,4,16,3754.27,5,5,5,15
16905,5,7,3102.43,5,5,5,15
16906,81,4,579.77,2,4,3,9
16907,29,5,981.65,4,4,4,12
16909,72,1,379.14,2,2,2,6
16910,4,8,1510.06,5,5,4,14
16912,28,11,2575.38,4,5,5,14
16913,290,1,113.44,1,2,1,4
16914,36,1,208.46,3,2,1,6
16915,9,6,621.6800000000001,5,5,3,13
16916,23,2,576.26,4,3,3,10
16917,276,1,391.52,1,2,2,5
16918,49,6,1068.82,3,5,4,12
16919,156,11,2596.45,2,5,5,12
16921,61,1,169.79,3,2,1,6
16923,12,19,7247.61,5,5,5,15
16924,21,3,846.75,4,4,3,11
16926,371,1,230.25,1,2,1,4
16927,115,3,543.05,2,4,3,9
16928,80,17,2847.6,2,5,5,12
16929,3,7,1295.39,5,5,4,14
16930,26,3,380.55,4,4,2,10
16931,5,21,4604.22,5,5,5,15
16932,53,1,161.94,3,2,1,6
16933,1,2,563.23,5,3,3,11
16934,54,2,950.9300000000001,3,3,4,10
16936,25,1,262.68,4,2,2,8
16938,8,4,2736.38,5,4,5,14
16940,52,3,3049.88,3,4,5,12
16942,12,9,1920.59,5,5,4,14
16943,211,3,816.73,1,4,3,8
16945,21,19,4345.5,4,5,5,14
16947,235,1,406.48,1,2,2,5
16948,138,3,435.02,2,4,2,8
16949,3,6,1286.27,5,5,4,14
16950,56,3,1178.56,3,4,4,11
16951,134,3,1277.75,2,4,4,10
16952,109,2,167.61,2,3,1,6
16953,30,1,20.8,4,2,1,7
16954,0,9,2085.08,5,5,5,15
16955,184,4,518.67,1,4,3,8
16956,17,1,308.74,4,2,2,8
16957,239,2,416.64,1,3,2,6
16959,87,1,117.35000000000001,2,2,1,5
16960,38,3,507.05,3,4,3,10
16961,116,1,234.17,2,2,1,5
16963,187,1,110.55000000000001,1,2,1,4
16965,226,1,201.19,1,2,1,4
16966,8,7,2154.97,5,5,5,15
16967,189,1,319.02,1,2,2,5
16968,4,2,439.43,5,3,2,10
16969,39,3,650.41,3,4,3,10
16971,38,1,357.21,3,2,2,7
16976,267,1,251.51999999999998,1,2,2,5
16978,77,1,344.33,2,2,2,6
16979,3,6,1852.0,5,5,4,14
16980,255,2,1078.96,1,3,4,8
16982,60,1,384.06,3,2,2,7
16983,12,7,1931.25,5,5,4,14
16984,88,2,4481.35,2,3,5,10
16985,17,10,5464.12,4,5,5,14
16986,29,2,1873.2,4,3,4,11
16987,3,7,1625.05,5,5,4,14
16988,5,1,126.12,5,2,1,8
16989,7,6,1133.25,5,5,4,14
16990,218,1,179.0,1,2,1,4
16992,10,5,1614.31,5,4,4,13
16996,30,6,1456.96,4,5,4,13
16997,288,3,702.0,1,4,3,8
16998,149,4,295.0,2,4,2,8
16999,23,2,484.82,4,3,2,9
17001,0,11,3989.57,5,5,5,15
17002,85,3,1493.73,2,4,4,10
17004,46,2,1412.94,3,3,4,10
17006,4,4,781.78,5,4,3,12
17007,50,6,889.9300000000001,3,5,3,11
17010,18,1,195.36,4,2,1,7
17011,30,1,270.9,4,2,2,8
17014,8,3,586.33,5,4,3,12
17015,28,3,1842.56,4,4,4,12
17017,2,20,8694.26,5,5,5,15
17018,40,2,920.1,3,3,3,9
17019,11,4,1272.61,5,4,4,13
17022,31,1,71.0,4,2,1,7
17024,45,3,95.85,3,4,1,8
17025,60,3,357.77,3,4,2,9
17026,185,2,154.82999999999998,1,3,1,5
17027,78,6,890.29,2,5,3,10
17029,110,2,716.0,2,3,3,8
17030,63,1,146.87,3,2,1,6
17031,11,2,380.35,5,3,2,10
17033,86,3,1030.14,2,4,4,10
17034,16,3,745.52,4,4,3,11
17035,245,2,433.53000000000003,1,3,2,6
17037,87,1,1267.32,2,2,4,8
17038,30,1,112.4,4,2,1,7
17040,137,1,449.73,2,2,2,6
17041,26,3,1081.57,4,4,4,12
17042,2,5,1044.3799999999999,5,4,4,13
17043,32,4,1735.18,4,4,4,12
17044,25,1,948.48,4,2,4,10
17045,113,3,339.44,2,4,2,8
17046,157,1,642.02,2,2,3,7
17047,85,3,1100.9,2,4,4,10
17048,117,3,925.35,2,4,3,9
17049,2,9,5659.9800000000005,5,5,5,15
17050,96,6,3228.84,2,5,5,12
17051,194,1,247.14000000000001,1,2,1,4
17052,28,1,413.75,4,2,2,8
17053,130,1,498.48,2,2,3,7
17054,28,5,1356.33,4,4,4,12
17058,81,3,1179.89,2,4,4,10
17059,29,5,3095.04,4,4,5,13
17060,266,1,234.24,1,2,1,4
17061,73,11,5232.2300000000005,2,5,5,12
17062,313,4,538.37,1,4,3,8
17063,21,7,1461.14,4,5,4,13
17064,58,3,859.35,3,4,3,10
17068,12,21,4552.14,5,5,5,15
17069,28,9,2709.7000000000003,4,5,5,14
17070,114,1,312.14,2,2,2,6
17071,28,9,2429.03,4,5,5,14
17073,17,4,1446.09,4,4,4,12
17075,17,4,834.12,4,4,3,11
17076,36,3,841.0799999999999,3,4,3,10
17078,36,2,378.2,3,3,2,8
17079,78,1,118.80000000000001,2,2,1,5
17080,22,2,287.62,4,3,2,9
17081,25,2,290.16,4,3,2,9
17082,33,2,2003.85,3,3,4,10
17083,109,3,1405.78,2,4,4,10
17084,35,2,2949.75,3,3,5,11
17085,123,5,1566.65,2,4,4,10
17086,7,6,2050.08,5,5,4,14
17088,28,4,1991.01,4,4,4,12
17090,4,7,2043.95,5,5,4,14
17091,2,9,3827.76,5,5,5,15
17092,50,4,1777.78,3,4,4,11
17094,322,1,302.0,1,2,2,5
17095,22,3,1324.16,4,4,4,12
17096,15,4,1022.13,4,4,4,12
17097,2,8,954.42,5,5,4,14
17100,18,2,971.74,4,3,4,11
17101,10,4,1621.73,5,4,4,13
17102,261,1,25.5,1,2,1,4
17105,159,2,665.78,2,3,3,8
17107,33,6,10815.43,3,5,5,13
17109,29,6,885.04,4,5,3,12
17110,165,1,163.29999999999998,2,2,1,5
17111,47,1,248.61,3,2,1,6
17114,5,8,808.62,5,5,3,13
17115,8,3,837.5,5,4,3,12
17117,288,1,116.19999999999999,1,2,1,4
17118,317,1,157.02,1,2,1,4
17119,3,2,606.91,5,3,3,11
17120,233,1,307.46,1,2,2,5
17122,119,1,138.32,2,2,1,5
17123,161,1,345.29999999999995,2,2,2,6
17124,185,1,298.89,1,2,2,5
17125,50,1,259.35,3,2,2,7
17126,152,5,1004.75,2,4,4,10
17128,334,1,157.09,1,2,1,4
17131,5,5,2463.17,5,4,5,14
17133,15,7,4892.240000000001,4,5,5,14
17134,106,2,425.0,2,3,2,7
17135,16,7,1139.73,4,5,4,13
17138,275,1,380.5,1,2,2,5
17139,15,12,10668.47,4,5,5,14
17140,247,1,465.32,1,2,2,5
17142,239,1,579.0,1,2,3,6
17144,1,2,984.57,5,3,4,12
17146,105,3,749.78,2,4,3,9
17147,22,4,1714.59,4,4,4,12
17148,51,1,124.88,3,2,1,6
17152,194,3,1689.5,1,4,4,9
17153,24,1,213.78,4,2,1,7
17154,75,1,329.34,2,2,2,6
17155,17,2,251.70000000000002,4,3,2,9
17157,7,2,319.0,5,3,2,10
17158,32,3,1266.97,4,4,4,12
17159,21,3,1538.88,4,4,4,12
17160,31,6,3518.03,4,5,5,14
17162,28,10,1715.46,4,5,4,13
17163,21,2,293.1,4,3,2,9
17164,32,7,2467.35,4,5,5,14
17165,284,1,158.68,1,2,1,4
17166,38,2,206.34,3,3,1,7
17169,57,2,835.78,3,3,3,9
17171,289,1,224.91,1,2,1,4
17172,78,1,317.76,2,2,2,6
17173,5,8,3766.6,5,5,5,15
17174,217,1,59.9,1,2,1,4
17175,44,4,1443.69,3,4,4,11
17176,201,1,306.13,1,2,2,5
17179,178,3,711.79,2,4,3,9
17180,56,4,796.03,3,4,3,10
17181,57,2,239.92000000000002,3,3,1,7
17183,7,6,3347.31,5,5,5,15
17186,46,2,144.0,3,3,1,7
17187,226,1,203.95,1,2,1,4
17188,11,7,2474.23,5,5,5,15
17189,106,2,384.40000000000003,2,3,2,7
17190,58,2,444.74,3,3,2,8
17191,28,7,2095.13,4,5,5,14
17193,35,7,1699.3000000000002,3,5,4,12
17194,273,2,262.62,1,3,2,6
17197,29,1,1013.01,4,2,4,10
17198,23,3,692.22,4,4,3,11
17201,53,1,342.63,3,2,2,7
17203,35,6,3563.85,3,5,5,13
17204,175,4,1564.56,2,4,4,10
17205,53,1,384.08,3,2,2,7
17206,53,1,204.24,3,2,1,6
17211,26,8,2317.2200000000003,4,5,5,14
17212,253,1,226.85,1,2,1,4
17213,40,7,2781.23,3,5,5,13
17214,60,6,1069.1200000000001,3,5,4,12
17217,234,1,113.5,1,2,1,4
17218,4,10,1960.72,5,5,4,14
17219,31,1,114.23,4,2,1,7
17220,24,14,3198.25,4,5,5,14
17221,7,2,335.13,5,3,2,10
17222,65,1,354.15,3,2,2,7
17223,310,2,426.79,1,3,2,6
17226,308,1,393.49,1,2,2,5
17227,18,6,939.32,4,5,3,12
17228,15,8,1906.09,4,5,4,13
17229,96,2,318.76,2,3,2,7
17230,264,8,3638.41,1,5,5,11
17231,12,10,3174.32,5,5,5,15
17232,2,2,421.52,5,3,2,10
17233,35,1,190.88,3,2,1,6
17234,182,1,149.89000000000001,1,2,1,4
17235,25,2,550.06,4,3,3,10
17236,12,6,916.13,5,5,3,13
17237,11,2,314.69,5,3,2,10
17238,2,17,3744.65,5,5,5,15
17239,312,1,382.5,1,2,2,5
17242,108,2,1135.04,2,3,4,9
17243,1,26,8676.85,5,5,5,15
17244,53,1,954.9,3,2,4,9
17245,204,1,171.45,1,2,1,4
17247,15,1,282.19,4,2,2,8
17248,120,1,318.65,2,2,2,6
17250,3,2,384.52,5,3,2,10
17251,362,1,283.28000000000003,1,2,2,5
17252,116,2,353.86,2,3,2,7
17253,18,1,178.26,4,2,1,7
17254,4,2,272.44,5,3,2,10
17255,40,2,298.41,3,3,2,8
17256,107,2,240.0,2,3,1,6
17259,148,2,603.37,2,3,3,8
17262,52,5,1253.3600000000001,3,4,4,11
17263,208,1,63.440000000000005,1,2,1,4
17265,138,2,562.9,2,3,3,8
17266,2,3,310.64,5,4,2,11
17267,127,2,317.62,2,3,2,7
17268,107,4,763.64,2,4,3,9
17272,42,4,2148.63,3,4,5,12
17274,35,1,111.97999999999999,3,2,1,6
17277,227,2,1065.3500000000001,1,3,4,8
17278,241,1,246.04,1,2,1,4
17279,57,1,187.82999999999998,3,2,1,6
17282,130,3,1703.41,2,4,4,10
17284,60,6,1652.58,3,5,4,12
17286,21,1,153.92,4,2,1,7
17287,26,7,1064.11,4,5,4,13
17288,9,7,1419.73,5,5,4,14
17289,31,3,944.41,4,4,4,12
17290,3,2,525.24,5,3,3,11
17291,308,1,550.8000000000001,1,2,3,6
17293,8,9,1875.1100000000001,5,5,4,14
17295,28,3,556.95,4,4,3,11
17297,17,1,131.78,4,2,1,7
17298,101,2,498.42,2,3,3,8
17299,11,4,669.11,5,4,3,12
17301,21,1,197.63,4,2,1,7
17302,14,5,1135.63,4,4,4,12
17303,361,1,250.04,1,2,1,4
17306,10,19,8631.31,5,5,5,15
17309,95,1,82.75,2,2,1,5
17311,78,2,1384.85,2,3,4,9
17312,138,3,644.3,2,4,3,9
17313,31,1,2328.84,4,2,5,11
17314,24,8,2527.92,4,5,5,14
17315,1,38,6292.26,5,5,5,15
17317,46,3,2600.34,3,4,5,12
17320,100,3,1200.6200000000001,2,4,4,10
17321,8,2,700.86,5,3,3,11
17323,15,7,921.07,4,5,3,12
17324,17,4,990.23,4,4,4,12
17325,280,1,96.8,1,2,1,4
17329,14,2,523.11,4,3,3,10
17330,22,2,363.9,4,3,2,9
17331,123,1,175.2,2,2,1,5
17333,85,1,494.25,2,2,3,7
17334,302,2,307.02,1,3,2,6
17337,151,4,2027.8700000000001,2,4,4,10
17338,17,8,6643.93,4,5,5,14
17339,94,2,243.36,2,3,1,6
17340,29,11,12353.29,4,5,5,14
17341,156,3,781.36,2,4,3,9
17343,355,1,193.64,1,2,1,4
17344,46,1,160.57,3,2,1,6
17345,15,4,537.74,4,4,3,11
17346,3,15,2676.56,5,5,5,15
17347,86,1,228.96,2,2,1,5
17348,14,5,1159.52,4,4,4,12
17349,179,1,110.75,2,2,1,5
17350,8,4,1286.07,5,4,4,13
17351,36,3,587.15,3,4,3,10
17353,129,2,1740.0,2,3,4,9
17354,50,1,1393.06,3,2,4,9
17356,311,1,178.22,1,2,1,4
17357,24,2,388.14,4,3,2,9
17358,303,2,365.85,1,3,2,6
17359,11,1,127.86,5,2,1,8
17360,17,3,585.79,4,4,3,11
17361,49,3,488.2,3,4,2,9
17362,239,2,312.23,1,3,2,6
17364,0,11,4481.18,5,5,5,15
17365,12,8,4801.56,5,5,5,15
17367,238,1,168.4,1,2,1,4
17368,23,8,1912.67,4,5,4,13
17370,72,4,446.18,2,4,2,8
17371,17,3,423.89,4,4,2,10
17372,40,8,1342.68,3,5,4,12
17373,40,4,646.92,3,4,3,10
17374,218,2,495.77,1,3,3,7
17375,199,3,400.1,1,4,2,7
17376,70,2,203.2,3,3,1,7
17377,23,20,4100.92,4,5,5,14
17379,11,1,404.66,5,2,2,9
17381,8,29,20275.61,5,5,5,15
17382,65,1,65.4,3,2,1,6
17383,4,1,199.29,5,2,1,8
17384,19,2,336.4,4,3,2,9
17385,14,1,261.11,4,2,2,8
17386,7,6,2686.42,5,5,5,15
17387,19,2,784.11,4,3,3,10
17388,77,4,1259.56,2,4,4,10
17389,0,34,31833.68,5,5,5,15
17391,163,2,508.8,2,3,3,8
17392,306,2,457.91,1,3,2,6
17394,219,1,203.86999999999998,1,2,1,4
17396,39,8,7330.8,3,5,5,13
17397,22,2,696.41,4,3,3,10
17398,114,3,653.38,2,4,3,9
17400,126,5,2129.96,2,4,5,11
17402,4,13,2633.85,5,5,5,15
17403,36,1,281.62,3,2,2,7
17404,4,15,31906.82,5,5,5,15
17405,1,3,1031.41,5,4,4,13
17406,333,3,2200.42,1,4,5,10
17408,163,1,32.65,2,2,1,5
17409,184,2,771.85,1,3,3,7
17410,16,5,1214.72,4,4,4,12
17411,12,3,778.94,5,4,3,12
17412,2,7,1258.06,5,5,4,14
17414,43,2,778.0,3,3,3,9
17415,79,1,507.84,2,2,3,7
17416,29,7,6893.42,4,5,5,14
17418,42,2,463.46000000000004,3,3,2,8
17419,11,12,4226.57,5,5,5,15
17420,50,3,598.83,3,4,3,10
17422,16,6,1979.37,4,5,4,13
17423,46,2,698.41,3,3,3,9
17425,19,2,759.17,4,3,3,10
17426,8,6,5037.26,5,5,5,15
17427,71,1,100.8,3,2,1,6
17428,0,28,17256.85,5,5,5,15
17429,128,3,524.9200000000001,2,4,3,9
17430,32,2,265.76,4,3,2,9
17431,313,1,403.3,1,2,2,5
17432,18,2,365.76,4,3,2,9
17433,88,1,303.15999999999997,2,2,2,6
17434,2,7,2373.82,5,5,5,15
17436,1,2,216.29999999999998,5,3,1,9
17438,253,1,388.45000000000005,1,2,2,5
17440,156,3,186.42000000000002,2,4,1,7
17442,36,6,2248.56,3,5,5,13
17443,219,1,534.24,1,2,3,6
17444,147,3,2940.04,2,4,5,11
17446,176,2,120.9,2,3,1,6
17447,40,2,541.53,3,3,3,9
17449,2,7,2520.86,5,5,5,15
17450,8,46,194550.79,5,5,5,15
17451,1,7,1721.4,5,5,4,14
17453,17,2,486.71999999999997,4,3,2,9
17454,192,4,517.53,1,4,3,8
17455,203,1,131.7,1,2,1,4
17456,365,1,249.86,1,2,1,4
17457,126,5,1737.7,2,4,4,10
17458,15,1,316.5,4,2,2,8
17459,43,2,657.3,3,3,3,9
17460,94,6,622.4300000000001,2,5,3,10
17461,22,3,757.46,4,4,3,11
17462,60,2,675.69,3,3,3,9
17463,16,5,1896.41,4,4,4,12
17464,158,1,289.96000000000004,2,2,2,6
17466,10,2,763.28,5,3,3,11
17468,10,2,137.0,5,3,1,9
17469,16,5,1870.97,4,4,4,12
17470,44,5,1125.07,3,4,4,11
17472,191,3,710.29,1,4,3,8
17475,79,1,194.37,2,2,1,5
17480,77,1,511.82,2,2,3,7
17481,3,4,1255.59,5,4,4,13
17483,65,3,414.04,3,4,2,9
17486,261,1,396.87,1,2,2,5
17489,58,2,376.64,3,3,2,8
17490,0,7,2092.32,5,5,5,15
17491,1,10,3558.87,5,5,5,15
17492,248,1,374.57,1,2,2,5
17495,7,2,497.56,5,3,3,11
17496,358,1,271.05,1,2,2,5
17498,75,1,272.22,2,2,2,6
17499,289,1,622.88,1,2,3,6
17500,17,3,1138.0,4,4,4,12
17501,220,2,288.6,1,3,2,6
17502,9,4,689.1,5,4,3,12
17503,2,2,558.96,5,3,3,11
17504,206,9,2997.0299999999997,1,5,5,11
17505,161,2,1145.84,2,3,4,9
17506,75,1,302.2,2,2,2,6
17507,261,2,605.58,1,3,3,7
17508,280,1,387.31,1,2,2,5
17509,57,8,6115.14,3,5,5,13
17510,24,1,308.48,4,2,2,8
17511,2,31,91062.38,5,5,5,15
17512,28,10,2924.9900000000002,4,5,5,14
17513,72,1,513.2,2,2,3,7
17514,128,1,208.65,2,2,1,5
17515,31,4,639.02,4,4,3,11
17516,15,5,768.08,4,4,3,11
17517,308,1,153.94,1,2,1,4
17519,17,6,1844.02,4,5,4,13
17520,53,1,546.81,3,2,3,8
17521,29,3,723.2099999999999,4,4,3,11
17522,1,5,1070.71,5,4,4,13
17523,11,4,652.74,5,4,3,12
17524,361,1,145.0,1,2,1,4
17525,359,1,422.70000000000005,1,2,2,5
17526,4,4,1195.8999999999999,5,4,4,13
17527,53,4,939.37,3,4,3,10
17528,1,8,3628.5,5,5,5,15
17530,1,10,2385.0,5,5,5,15
17531,190,1,296.7,1,2,2,5
17534,53,1,223.36,3,2,1,6
17535,280,1,164.4,1,2,1,4
17536,177,1,76.5,2,2,1,5
17537,29,2,897.62,4,3,3,10
17538,25,1,98.42,4,2,1,7
17540,24,2,578.9,4,3,3,10
17542,269,1,170.75,1,2,1,4
17545,43,3,645.96,3,4,3,10
17548,233,1,103.3,1,2,1,4
17549,23,2,148.86,4,3,1,8
17550,197,3,267.16,1,4,2,7
17551,359,1,306.84,1,2,2,5
17552,60,4,930.41,3,4,3,10
17553,129,1,1487.6,2,2,4,8
17554,1,5,1952.45,5,4,4,13
17555,19,2,483.26,4,3,2,9
17556,205,1,157.9,1,2,1,4
17557,14,3,541.46,4,4,3,11
17560,94,5,854.95,2,4,3,9
17561,19,1,167.62,4,2,1,7
17562,14,7,1122.38,4,5,4,13
17564,24,3,454.01,4,4,2,10
17566,8,2,901.21,5,3,3,11
17567,7,8,4331.48,5,5,5,15
17569,332,1,344.14,1,2,2,5
17571,50,4,1498.51,3,4,4,11
17572,71,4,226.75000000000003,3,4,1,8
17573,29,3,380.6,4,4,2,10
17574,242,1,185.65,1,2,1,4
17576,8,19,3622.68,5,5,5,15
17578,218,1,143.45999999999998,1,2,1,4
17579,4,3,448.90000000000003,5,4,2,11
17580,252,3,215.72,1,4,1,6
17581,0,25,11045.04,5,5,5,15
17582,236,1,175.27,1,2,1,4
17584,7,2,1242.3,5,3,4,12
17585,109,4,1133.07,2,4,4,10
17588,100,3,1240.2,2,4,4,10
17589,60,4,2404.17,3,4,5,12
17590,2,3,1479.22,5,4,4,13
17591,73,7,2225.9700000000003,2,5,5,12
17593,3,5,3927.34,5,4,5,14
17594,85,2,993.18,2,3,4,9
17595,12,2,388.79,5,3,2,10
17596,23,7,2827.93,4,5,5,14
17597,213,1,2044.3700000000001,1,2,4,7
17600,17,1,161.67000000000002,4,2,1,7
17601,239,1,116.00999999999999,1,2,1,4
17602,2,6,5102.97,5,5,5,15
17603,78,1,394.72,2,2,2,6
17604,217,2,309.36,1,3,2,6
17608,33,2,193.42,3,3,1,7
17609,40,5,1112.22,3,4,4,11
17611,7,15,3984.22,5,5,5,15
17612,53,6,2048.45,3,5,4,12
17613,22,14,4559.150000000001,4,5,5,14
17614,57,1,390.07,3,2,2,7
17615,130,3,329.6,2,4,2,8
17616,173,3,571.1999999999999,2,4,3,9
17618,5,3,971.58,5,4,4,13
17619,312,1,218.52,1,2,1,4
17620,59,1,81.44,3,2,1,6
17621,21,3,1379.9,4,4,4,12
17623,32,1,527.0500000000001,4,2,3,9
17624,14,2,843.48,4,3,3,10
17625,18,4,2047.0,4,4,4,12
17628,81,1,75.75,2,2,1,5
17629,5,8,1814.12,5,5,4,14
17630,169,2,503.59999999999997,2,3,3,8
17631,1,3,528.33,5,4,3,12
17633,31,4,1324.84,4,4,4,12
17634,36,9,2361.9700000000003,3,5,5,13
17636,19,1,285.56,4,2,2,8
17637,31,2,547.0600000000001,4,3,3,10
17639,276,1,108.5,1,2,1,4
17640,86,1,621.66,2,2,3,7
17642,119,2,712.29,2,3,3,8
17643,373,1,101.55,1,2,1,4
17644,1,11,2895.64,5,5,5,15
17646,219,3,1008.39,1,4,4,9
17647,65,1,133.06,3,2,1,6
17648,60,4,1797.5,3,4,4,11
17649,138,1,868.49,2,2,3,7
17650,21,1,166.08,4,2,1,7
17651,11,10,3945.0,5,5,5,15
17652,25,12,4867.72,4,5,5,14
17653,36,4,1207.56,3,4,4,11
17654,277,1,117.55,1,2,1,4
17655,10,7,2638.94,5,5,5,15
17656,73,5,1674.69,2,4,4,10
17658,25,2,595.42,4,3,3,10
17659,17,12,2999.46,4,5,5,14
17660,141,1,196.0,2,2,1,5
17663,25,7,1802.91,4,5,4,13
17664,18,2,604.64,4,3,3,10
17666,3,2,728.16,5,3,3,11
17667,66,5,2055.51,3,4,4,11
17668,1,2,347.75,5,3,2,10
17669,42,7,3406.7200000000003,3,5,5,13
17670,227,1,205.7,1,2,1,4
17671,15,4,1572.71,4,4,4,12
17672,50,2,3178.17,3,3,5,11
17673,1,6,1629.12,5,5,4,14
17674,74,2,551.04,2,3,3,8
17675,1,31,20374.28,5,5,5,15
17676,4,6,1387.68,5,5,4,14
17677,1,30,16363.23,5,5,5,15
17678,263,1,298.11,1,2,2,5
17679,52,2,1992.1100000000001,3,3,4,10
17680,23,1,184.4,4,2,1,7
17682,10,6,2474.33,5,5,5,15
17684,43,1,239.41,3,2,1,6
17685,16,7,3191.53,4,5,5,14
17686,7,7,5739.46,5,5,5,15
17690,30,15,4757.95,4,5,5,14
17691,358,2,290.40000000000003,1,3,2,6
17692,127,4,740.9399999999999,2,4,3,9
17693,137,1,200.47,2,2,1,5
17694,141,1,283.12,2,2,2,6
17695,131,2,765.34,2,3,3,8
17696,38,8,2285.71,3,5,5,13
17697,236,1,338.95,1,2,2,5
17698,260,1,154.95,1,2,1,4
17700,16,4,2534.64,4,4,5,13
17701,252,1,417.95,1,2,2,5
17702,30,4,1824.37,4,4,4,12
17703,35,3,798.74,3,4,3,10
17704,168,2,885.19,2,3,3,8
17705,3,9,1823.52,5,5,4,14
17706,4,17,10504.49,5,5,5,15
17707,185,2,152.4,1,3,1,5
17708,187,2,267.08,1,3,2,6
17709,169,1,137.45,2,2,1,5
17711,10,2,385.1,5,3,2,10
17712,44,1,522.91,3,2,3,8
17714,320,1,153.0,1,2,1,4
17715,200,1,326.4,1,2,2,5
17716,22,11,5655.99,4,5,5,14
17718,232,1,139.35,1,2,1,4
17719,37,15,5396.04,3,5,5,13
17720,26,4,1195.94,4,4,4,12
17722,96,4,2424.04,2,4,5,11
17723,127,6,3276.4000000000005,2,5,5,12
17724,71,3,1033.0,3,4,4,11
17725,16,11,3439.08,4,5,5,14
17727,15,1,1060.25,4,2,4,10
17728,3,3,2876.01,5,4,5,14
17730,3,13,5298.4800000000005,5,5,5,15
17731,79,4,1240.11,2,4,4,10
17732,372,1,303.97,1,2,2,5
17733,38,2,692.19,3,3,3,9
17734,53,3,700.63,3,4,3,10
17735,2,19,13110.02,5,5,5,15
17736,9,3,377.44,5,4,2,11
17737,9,2,168.24,5,3,1,9
17738,19,4,1879.05,4,4,4,12
17739,11,7,2791.35,5,5,5,15
17742,113,2,355.11,2,3,2,7
17744,3,6,2322.4,5,5,5,15
17746,240,1,110.25,1,2,1,4
17747,112,1,71.4,2,2,1,5
17749,178,2,674.52,2,3,3,8
17750,5,9,1797.57,5,5,4,14
17752,359,1,80.64,1,2,1,4
17754,0,5,1772.26,5,4,4,13
17757,1,30,5605.29,5,5,5,15
17758,19,8,3456.7000000000003,4,5,5,14
17759,17,3,834.99,4,4,3,11
17760,21,2,287.59,4,3,2,9
17761,32,1,712.78,4,2,3,9
17763,263,1,15.0,1,2,1,4
17764,50,2,818.8199999999999,3,3,3,9
17765,158,3,371.88,2,4,2,8
17767,15,1,271.2,4,2,2,8
17768,8,3,2273.1800000000003,5,4,5,14
17769,12,10,3997.98,5,5,5,15
17770,198,5,1143.27,1,4,4,9
17771,56,2,245.81,3,3,1,7
17772,10,2,182.77,5,3,1,9
17774,96,4,1225.41,2,4,4,10
17775,254,1,56.4,1,2,1,4
17777,24,3,665.86,4,4,3,11
17779,21,3,658.57,4,4,3,11
17781,159,2,188.02,2,3,1,6
17783,72,2,283.47,2,3,2,7
17785,53,1,131.94,3,2,1,6
17786,85,2,278.74,2,3,2,7
17787,152,4,1865.19,2,4,4,10
17788,73,2,1117.9,2,3,4,9
17789,281,1,225.9,1,2,1,4
17790,26,14,1965.55,4,5,4,13
17791,29,1,106.1,4,2,1,7
17793,25,1,323.04,4,2,2,8
17795,179,2,350.39,2,3,2,7
17796,40,4,697.9,3,4,3,10
17797,22,3,780.43,4,4,3,11
17799,22,10,3055.93,4,5,5,14
17800,37,9,1199.01,3,5,4,12
17802,82,3,1285.04,2,4,4,10
17805,73,1,512.31,2,2,3,7
17806,11,1,546.04,5,2,3,10
17809,16,12,5411.91,4,5,5,14
17811,4,39,7837.7300000000005,5,5,5,15
17812,12,4,732.16,5,4,3,12
17813,14,5,1770.8799999999999,4,4,4,12
17816,36,4,36.56,3,4,1,8
17817,4,3,387.68,5,4,2,11
17819,71,7,3704.87,3,5,5,13
17824,51,1,298.4,3,2,2,7
17827,5,5,1995.46,5,4,4,13
17828,22,4,1820.09,4,4,4,12
17829,298,1,889.24,1,2,3,6
17830,1,3,398.7,5,4,2,11
17831,33,1,35.400000000000006,3,2,1,6
17832,49,1,155.37,3,2,1,6
17835,2,3,350.64,5,4,2,11
17836,47,1,110.21000000000001,3,2,1,6
17837,42,8,1593.38,3,5,4,12
17838,26,5,2779.3,4,4,5,13
17839,42,1,338.8,3,2,2,7
17841,1,124,40991.57,5,5,5,15
17843,303,1,205.48,1,2,1,4
17844,106,1,51.559999999999995,2,2,1,5
17846,85,1,2033.1,2,2,4,8
17848,81,9,901.1999999999999,2,5,3,10
17849,218,4,605.8000000000001,1,4,3,8
17850,372,34,5391.21,1,5,5,11
17852,11,2,114.34,5,3,1,9
17854,185,2,311.26,1,3,2,6
17855,372,1,208.97,1,2,1,4
17856,1,4,1418.03,5,4,4,13
17857,4,23,26879.04,5,5,5,15
17858,5,12,5155.66,5,5,5,15
17859,304,1,148.21,1,2,1,4
17860,368,1,252.8,1,2,2,5
17861,3,8,2100.8,5,5,5,15
17862,323,1,330.9,1,2,2,5
17863,59,6,3160.0,3,5,5,13
17864,12,3,597.5,5,4,3,12
17865,30,20,10526.32,4,5,5,14
17866,142,1,329.65,2,2,2,6
17867,30,6,1197.1000000000001,4,5,4,13
17869,107,5,428.18,2,4,2,8
17870,2,12,1894.35,5,5,4,14
17871,204,1,155.9,1,2,1,4
17873,80,5,1859.16,2,4,4,10
17874,185,6,683.46,1,5,3,9
17877,170,1,237.61,2,2,1,5
17878,43,1,379.45,3,2,2,7
17879,173,1,178.51999999999998,2,2,1,5
17880,364,1,458.92,1,2,2,5
17881,304,1,133.35000000000002,1,2,1,4
17883,3,4,671.77,5,4,3,12
17884,3,4,717.45,5,4,3,12
17885,12,1,190.19,5,2,1,8
17886,31,3,899.61,4,4,3,11
17887,129,1,111.35,2,2,1,5
17888,21,8,726.05,4,5,3,12
17889,212,2,203.87,1,3,1,5
17890,322,2,602.09,1,3,3,7
17891,162,1,203.85999999999999,2,2,1,5
17892,56,3,244.1,3,4,1,8
17893,225,1,112.25,1,2,1,4
17894,71,8,1119.81,3,5,4,12
17895,44,1,98.0,3,2,1,6
17896,23,1,256.32,4,2,2,8
17897,172,3,566.6,2,4,3,9
17898,85,2,152.06,2,3,1,6
17899,159,1,155.8,2,2,1,5
17900,190,2,112.19999999999999,1,3,1,5
17901,29,1,110.38,4,2,1,7
17904,21,1,191.67,4,2,1,7
17905,71,4,800.24,3,4,3,10
17906,247,1,72.9,1,2,1,4
17908,373,1,243.28,1,2,1,4
17911,9,1,366.23,5,2,2,9
17912,310,5,311.01,1,4,2,7
17913,58,2,411.6,3,3,2,8
17914,3,1,336.43,5,2,2,9
17917,45,3,341.28,3,4,2,9
17919,88,1,1304.04,2,2,4,8
17920,4,17,4204.1,5,5,5,15
17921,64,4,826.52,3,4,3,10
17923,282,1,207.50000000000003,1,2,1,4
17924,11,7,2962.5,5,5,5,15
17925,372,1,244.08,1,2,1,4
17926,133,2,397.29,2,3,2,7
17928,45,2,212.54,3,3,1,7
17929,11,4,843.0,5,4,3,12
17930,35,5,1740.48,3,4,4,11
17931,134,2,408.36,2,3,2,7
17932,29,3,1331.57,4,4,4,12
17934,51,2,704.25,3,3,3,9
17935,138,2,145.79,2,3,1,6
17936,5,1,389.84,5,2,2,9
17937,8,7,4301.22,5,5,5,15
17939,159,1,99.14,2,2,1,5
17940,49,10,4106.4400000000005,3,5,5,13
17941,130,1,304.56,2,2,2,6
17942,7,1,77.50000000000001,5,2,1,8
17946,233,2,149.57999999999998,1,3,1,5
17947,37,1,176.68,3,2,1,6
17948,147,1,358.56000000000006,2,2,2,6
17949,1,45,58510.48,5,5,5,15
17950,72,3,482.2,2,4,2,8
17951,39,3,1008.5400000000001,3,4,4,11
17954,5,12,2332.72,5,5,5,15
17955,198,4,557.3,1,4,3,8
17956,249,1,12.75,1,2,1,4
17957,66,1,111.68,3,2,1,6
17958,116,1,508.4599999999999,2,2,3,7
17960,171,1,73.78,2,2,1,5
17961,21,39,1296.44,4,5,4,13
17962,142,1,102.83,2,2,1,5
17964,31,2,471.7,4,3,2,9
17965,37,14,2622.57,3,5,5,13
17966,37,5,1098.43,3,4,4,11
17967,371,1,123.07,1,2,1,4
17968,373,1,277.35,1,2,2,5
17969,166,2,228.2,2,3,1,6
17970,211,1,582.59,1,2,3,6
17972,241,1,136.04,1,2,1,4
17973,51,1,337.04,3,2,2,7
17974,24,3,740.79,4,4,3,11
17975,15,13,4488.81,4,5,5,14
17976,372,1,353.19,1,2,2,5
17977,29,1,288.14,4,2,2,8
17978,365,1,300.91999999999996,1,2,2,5
17979,35,4,757.71,3,4,3,10
17980,165,3,811.45,2,4,3,9
17984,145,1,152.68,2,2,1,5
17985,22,1,634.95,4,2,3,9
17986,56,1,20.8,3,2,1,6
17987,185,1,198.57,1,2,1,4
17988,11,7,201.12,5,5,1,11
17990,236,3,630.84,1,4,3,8
17991,225,2,93.35,1,3,1,5
17994,121,4,678.49,2,4,3,9
17995,281,1,76.1,1,2,1,4
17997,74,8,1970.6699999999998,2,5,4,11
17999,37,2,382.06,3,3,2,8
18001,12,2,417.23,5,3,2,10
18004,362,1,169.47,1,2,1,4
18005,3,2,249.72,5,3,1,9
18006,23,1,444.68,4,2,2,8
18008,70,9,2116.19,3,5,5,13
18009,235,1,257.34,1,2,2,5
18010,256,1,174.8,1,2,1,4
18011,373,1,102.78999999999999,1,2,1,4
18013,155,2,187.29,2,3,1,6
18014,28,1,166.42,4,2,1,7
18015,4,1,120.03,5,2,1,8
18016,32,5,1483.56,4,4,4,12
18017,81,3,523.0,2,4,3,9
18018,108,2,122.14,2,3,1,6
18019,51,1,38.45,3,2,1,6
18022,35,1,668.11,3,2,3,8
18024,152,2,389.78,2,3,2,7
18027,98,1,115.31,2,2,1,5
18030,4,2,230.64999999999998,5,3,1,9
18032,334,1,73.5,1,2,1,4
18033,65,1,97.97,3,2,1,6
18034,21,2,422.88,4,3,2,9
18035,35,3,730.4,3,4,3,10
18036,32,3,405.62,4,4,2,10
18037,154,6,70.02,2,5,1,8
18040,19,2,357.20000000000005,4,3,2,9
18041,11,21,4183.39,5,5,5,15
18042,53,1,165.04999999999998,3,2,1,6
18043,24,3,559.51,4,4,3,11
18044,4,10,2088.6,5,5,5,15
18045,45,1,189.4,3,2,1,6
18048,203,2,172.29000000000002,1,3,1,5
18050,359,1,74.4,1,2,1,4
18053,70,1,300.02,3,2,2,7
18055,7,10,6784.1900000000005,5,5,5,15
18056,288,1,363.65,1,2,2,5
18058,9,1,170.16,5,2,1,8
18059,23,3,306.46,4,4,2,10
18061,21,10,2119.41,4,5,5,14
18062,173,3,720.52,2,4,3,9
18064,133,2,814.0,2,3,3,8
18065,5,14,2392.83,5,5,5,15
18066,75,1,318.0,2,2,2,6
18067,40,1,396.33,3,2,2,7
18068,289,1,101.69999999999999,1,2,1,4
18069,26,5,2036.67,4,4,4,12
18071,257,2,453.0,1,3,2,6
18072,185,1,247.44,1,2,1,4
18073,114,12,3877.5200000000004,2,5,5,12
18074,373,1,489.6,1,2,2,5
18075,23,10,2611.75,4,5,5,14
18077,8,11,2633.0099999999998,5,5,5,15
18078,217,2,336.13,1,3,2,6
18079,45,4,3651.97,3,4,5,12
18080,18,2,1231.5,4,3,4,11
18081,36,3,343.45,3,4,2,9
18082,25,1,703.37,4,2,3,9
18084,16,1,90.47999999999999,4,2,1,7
18085,330,2,689.95,1,3,3,7
18086,274,1,101.34,1,2,1,4
18087,98,2,4055.7199999999993,2,3,5,10
18088,61,1,167.67000000000002,3,2,1,6
18092,2,11,9068.26,5,5,5,15
18093,93,4,2106.52,2,4,5,11
18094,81,7,3017.3,2,5,5,12
18095,312,2,580.0500000000001,1,3,3,7
18096,11,3,911.15,5,4,3,12
18097,7,6,2697.8,5,5,5,15
18099,127,1,168.31,2,2,1,5
18101,11,2,223.65,5,3,1,9
18102,0,60,259657.3,5,5,5,15
18104,37,1,754.64,3,2,3,8
18105,37,1,113.48000000000002,3,2,1,6
18106,329,1,430.7,1,2,2,5
18108,254,1,271.0,1,2,2,5
18109,1,26,8052.97,5,5,5,15
18110,19,1,236.3,4,2,1,7
18112,12,2,352.69,5,3,2,10
18113,368,1,76.32000000000001,1,2,1,4
18114,290,1,220.1,1,2,1,4
18116,67,8,1418.03,3,5,4,12
18117,25,1,320.72,4,2,2,8
18118,10,26,5653.82,5,5,5,15
18119,367,1,181.12,1,2,1,4
18120,214,1,111.15,1,2,1,4
18121,149,2,673.1,2,3,3,8
18122,8,6,1826.21,5,5,4,14
18123,24,2,589.4399999999999,4,3,3,10
18125,29,4,1142.99,4,4,4,12
18126,60,1,206.82999999999998,3,2,1,6
18127,19,3,348.73,4,4,2,10
18129,243,1,112.55000000000001,1,2,1,4
18130,15,3,1059.39,4,4,4,12
18133,212,1,931.4999999999999,1,2,3,6
18135,29,5,681.9100000000001,4,4,3,11
18136,63,3,784.33,3,4,3,10
18138,295,1,152.65,1,2,1,4
18139,17,6,8438.34,4,5,5,14
18142,157,2,1019.52,2,3,4,9
18143,116,2,1000.16,2,3,4,9
18144,7,12,2888.75,5,5,5,15
18145,12,4,2861.55,5,4,5,14
18146,140,2,160.35000000000002,2,3,1,6
18147,45,2,179.33999999999997,3,3,1,7
18149,50,3,612.0799999999999,3,4,3,10
18150,32,3,566.58,4,4,3,11
18151,134,2,653.35,2,3,3,8
18154,3,2,399.19,5,3,2,10
18155,75,3,371.62,2,4,2,8
18156,12,2,734.94,5,3,3,11
18158,9,2,453.4,5,3,2,10
18159,301,1,530.15,1,2,3,6
18160,57,2,638.0600000000001,3,3,3,9
18161,15,5,1618.69,4,4,4,12
18164,37,1,399.65000000000003,3,2,2,7
18165,177,1,302.46000000000004,2,2,2,6
18167,23,3,1384.8600000000001,4,4,4,12
18168,176,6,1169.94,2,5,4,11
18169,60,1,202.65,3,2,1,6
18170,33,3,980.31,3,4,4,11
18171,58,5,1231.31,3,4,4,11
18172,14,20,7561.68,4,5,5,14
18173,86,4,2106.84,2,4,5,11
18174,7,1,104.0,5,2,1,8
18176,358,1,476.35,1,2,2,5
18177,31,6,1341.42,4,5,4,13
18178,128,4,1590.81,2,4,4,10
18179,9,6,1793.17,5,5,4,14
18180,4,6,1843.75,5,5,4,14
18181,24,1,382.8,4,2,2,8
18183,227,2,632.07,1,3,3,7
18184,15,1,49.8,4,2,1,7
18185,249,1,304.25,1,2,2,5
18188,15,3,2001.04,4,4,4,12
18189,77,2,1090.24,2,3,4,9
18190,192,2,284.46000000000004,1,3,2,6
18191,261,1,207.79999999999998,1,2,1,4
18192,71,1,957.97,3,2,4,9
18193,165,1,243.76,2,2,1,5
18194,82,1,973.8399999999999,2,2,4,8
18196,95,2,689.13,2,3,3,8
18198,4,17,5425.56,5,5,5,15
18200,106,1,163.8,2,2,1,5
18202,199,3,1396.99,1,4,4,9
18203,157,1,160.42000000000002,2,2,1,5
18204,71,3,1993.7,3,4,4,11
18205,36,2,517.36,3,3,3,9
18209,28,1,139.10000000000002,4,2,1,7
18210,1,6,2621.38,5,5,5,15
18211,25,5,600.07,4,4,3,11
18212,326,1,248.42,1,2,1,4
18213,236,1,232.48000000000002,1,2,1,4
18215,89,1,299.34000000000003,2,2,2,6
18216,31,1,481.75,4,2,2,8
18217,29,2,621.75,4,3,3,10
18218,211,2,662.08,1,3,3,7
18219,2,10,2069.77,5,5,5,15
18220,226,1,305.28000000000003,1,2,2,5
18221,22,5,1041.61,4,4,4,12
18222,92,1,443.0,2,2,2,6
18223,4,14,6484.54,5,5,5,15
18224,263,1,158.95000000000002,1,2,1,4
18225,3,12,5509.12,5,5,5,15
18226,44,11,5228.05,3,5,5,13
18227,217,1,93.75,1,2,1,4
18228,56,2,779.9,3,3,3,9
18229,11,20,7276.900000000001,5,5,5,15
18230,9,7,2810.2000000000003,5,5,5,15
18231,192,5,2083.27,1,4,5,10
18232,81,4,592.97,2,4,3,9
18233,325,1,440.0,1,2,2,5
18235,71,3,1796.48,3,4,4,11
18236,29,6,882.24,4,5,3,12
18237,2,5,987.1,5,4,4,13
18239,218,5,1561.6100000000001,1,4,4,9
18240,46,1,422.58,3,2,2,7
18241,9,17,2073.09,5,5,5,15
18242,72,4,2232.4900000000002,2,4,5,11
18245,7,7,2567.06,5,5,5,15
18246,23,2,596.1,4,3,3,10
18248,122,2,804.02,2,3,3,8
18249,17,1,95.34,4,2,1,7
18250,310,1,349.27,1,2,2,5
18251,87,1,4314.72,2,2,5,9
18252,50,2,526.67,3,3,3,9
18255,89,1,103.3,2,2,1,5
18257,39,8,2337.63,3,5,5,13
18259,24,3,2338.6000000000004,4,4,5,13
18260,172,6,2643.2000000000003,2,5,5,12
18261,43,2,324.24,3,3,2,8
18262,140,1,149.48,2,2,1,5
18263,25,3,1213.1599999999999,4,4,4,12
18265,72,2,801.51,2,3,3,8
18268,134,1,25.5,2,2,1,5
18269,366,1,168.6,1,2,1,4
18270,38,2,283.15,3,3,2,8
18272,2,6,3078.58,5,5,5,15
18273,2,3,204.0,5,4,1,10
18274,30,1,175.92,4,2,1,7
18276,43,1,335.86,3,2,2,7
18277,58,1,110.38,3,2,1,6
18278,73,1,173.9,2,2,1,5
18280,277,1,180.60000000000002,1,2,1,4
18281,180,1,80.82,1,2,1,4
18282,7,2,178.05,5,3,1,9
18283,3,16,2094.88,5,5,5,15
18287,42,3,1837.28,3,4,4,11
